阿谀奉承=攀龙趋凤
哀悼=悲悼
哀鸿遍野=百孔千疮
哀求=恳求
哀伤=悲悼
哀痛=悲伤
挨饿=受饿
爱财如命=一毛不拔
爱崇=尊崇
爱戴=恋慕
爱好=喜好
爱护=敬服
爱慕=恋慕
爱情=恋爱
爱惜=敬服
安顿=安置
安放=安顿
安分=循分
安分守纪=循规蹈矩
安抚=抚慰
安家立业=克绍箕裘
安静=平静
安居乐业=安身立命
安眠=安息
安宁=安定
安排=摆设
安全=宁静
安然无恙=平安无事
安身立命=安居乐业
安慰=慰藉
安稳=牢固
安详=宁静
安心=放心
安逸=清闲
安置=安顿
按摩=推拿
按期=定期
按时=定时
按照=根据
暗暗=悄悄
暗藏=潜伏
暗淡=昏暗
暗号=灯号
暗箭=冷箭
暗箭伤人=含沙射影
暗杀=谋害
暗示=表示
暗算=暗杀
昂首=抬头
遨游=翱翔
熬煎=折磨
翱翔=飞翔
傲慢=狂妄
奥秘=秘密
奥妙=玄妙
懊悔=悔恨
懊丧=悔恨
八两半斤=不相上下
八门五花=五花八门
八面玲珑=八面见光
八面受敌=四面楚歌
八面威风=气势汹汹
巴结=逢迎
把脉=切脉
把握=掌握
把戏=花招
罢工=歇工
罢免=撤职
霸道=蛮横
霸占=攻克
白痴=呆子
白发=鹤发
白费=白搭
白日=白天
白天=白昼
白皙=白净
百般=千般
百里挑一=寥寥无几
百无禁忌=童言无忌
百姓=黎民
百折不挠=百折不回
摆架子=搭架子
摆设=部署
摆脱=挣脱
败坏=松弛
败类=莠民
败露=败事
拜别=离别
拜访=造访
拜见=参见
拜年=贺年
拜托=托付
颁发=发表
斑白=花白
搬家=搬迁
搬弄=挑衅
搬弄是非=挑拨离间
搬迁=搬家
办法=措施
办好=办妥
办理=管理
办事=服务
办妥=办好
半斤八两=旗鼓相当
半途=中途
半途而废=功败垂成
半推半就=不即不离
半信半疑=将信将疑
伴侣=朋友
伴随=陪同
伴同=随同
扮演=饰演
帮忙=帮助
帮手=帮忙
帮助=资助
绑缚=捆绑
榜样=模范
傍边=当中
傍观=旁观
傍门=歪路
傍晚=薄暮
包办=包揽
包庇=容隐
包藏祸心=心怀叵测
包含=包罗
包涵=包容
包括=包罗
包揽=包办
包罗万象=应有尽有
包容=包涵
包围=困绕
褒贬=批驳
宝贝=宝物
宝贵=名贵
宝物=宝贝
饱经风霜=坚苦卓绝
保藏=收藏
保存=生存
保护=掩护
保留=保存
保守=守旧
保卫=守卫
保养=调养
保证=包管
报答=报酬
报复=抨击
报告=陈诉
抱不平=行侠仗义
抱负=理想
抱恨=怀愁
抱歉=歉仄
抱怨=诉苦
暴动=暴乱
暴风=狂风
暴露=袒露
暴露无遗=原形毕露
暴乱=暴动
暴跳如雷=大发雷霆
暴躁=急躁
爆发=发作
卑鄙=鄙俚
卑躬屈膝=奴颜媚骨
卑贱=猥贱
卑劣=卑鄙
卑劣手段=鬼蜮伎俩
悲哀=悲痛
悲惨=悲凉
悲观=灰心
悲欢离合=离合悲欢
悲凉=悲惨
悲伤=伤心
悲叹=叹伤
悲痛=悲伤
备案=存案
背道而驰=南辕北辙
背景=配景
背面=反面
背叛=叛逆
被骗=受骗
奔波=奔忙
奔驰=疾驰
奔放=旷达
奔跑=奔驰
奔腾=奔驰
本地=当地
本分=天职
本来=原来
本领=本事
本末倒置=舍本逐末
本钱=资本
本身=自己
本事=本领
本性=天性
本性难移=个性难改
笨蛋=笨伯
笨头笨脑=傻里傻气
笨重=粗笨
笨拙=鸠拙
崩溃=瓦解
逼近=迫近
逼良为娼=迫良为娼
逼迫=欺压
逼上梁山=铤而走险
逼真=传神
比比皆是=触目皆是
比较=比力
比拟=相比
比如=好比
比赛=角逐
比手划脚=指手画脚
比武=交锋
比翼双飞=夫唱妇随
彼此=相互
笔迹=字迹
笔记=条记
笔直=笔挺
鄙视=藐视
必定=肯定
必恭必敬=恭恭敬敬
必然=一定
必需=必须
必要=须要
毕竟=究竟
毕业=结业
闭口=缄口
闭月羞花=花容月貌
庇护=保护
弊端=毛病
避讳=避忌
避祸=逃难
避忌=避讳
避免=制止
避难=遁迹
边界=界限
边境=疆域
边缘=边沿
编缉=主笔
编制=体例
鞭策=推动
鞭挞=鞭笞
便宜=自制
变成=酿成
变动=变更
变革=厘革
变更=变动
变化=变革
变化多端=变化无穷
变化无穷=变化多端
变幻=幻化
变幻莫测=变化多端
变换=变更
变节=背叛
变乱=事故
变态=失常
遍地=各处
遍体鳞伤=体无完肤
辩驳=反驳
辩论=辩说
标记=标志
标志=标记
标准=尺度
表白=表明
表露=暴露
表率=楷模
表面=外貌
表情=心情
表示=表现
表态=亮相
表现=体现
表演=演出
表扬=表彰
表彰=表扬
别出心裁=自出机杼
别具一格=别开生面
别离=分别
别有用心=醉翁之意
宾客=来宾
冰冷=酷寒
冰凉=冰冷
冰清玉洁=不染纤尘
兵变=叛乱
兵力=军力
兵马=戎马
兵器=武器
秉承=承袭
禀赋=天禀
并且=而且
病愈=全愈
波动=颠簸
波澜=波涛
波折=妨害
剥削=聚敛
驳斥=驳倒
博爱=泛爱
博古通今=博学多闻
博览会=展览会
搏斗=屠杀
薄弱=单薄
补偿=赔偿
补充=增补
补救=调停
补助=补贴
捕风捉影=疑神疑鬼
捕获=捕捉
捕捉=捕获
不便=未便
不变=稳定
不才=鄙人
不辞劳苦=不辞劳怨
不单=不但
不但=不光
不当=不妥
不断=不停
不法=非法
不凡=非凡
不服=不平
不该=不应
不够=不敷
不顾=掉臂
不光=不但
不过=不外
不好=欠好
不和=反面
不计其数=不可胜数
不仅=不但
不肯=不愿
不利=倒霉
不料=不意
不留神=不留心
不留余地=杀鸡取卵
不伦不类=不正经
不论=岂论
不免=难免
不能自已=不能自制
不然=否则
不辱使命=幸不辱命
不三不四=不伦不类
不识时务=不识时变
不停=不绝
不同=差别
不同凡响=与众不同
不妥=不当
不务正业=吊儿郎当
不惜=不吝
不相上下=平分秋色
不行=不可
不修边幅=囚首垢面
不言而喻=不问可知
不要紧=没关系
不遗余力=尽心尽力
不用=不消
不由自主=情不自禁
不愿=不肯
不约而同=不谋而合
不曾=未曾
不只=不但
不准=禁绝
不着边际=天南地北
不自量力=蚍蜉撼树
不足=不敷
不足为奇=屡见不鲜
布景=背景
布局=结构
布满=充满
布置=部署
步队=队伍
步伐=步调
步骤=步调
部队=队伍
部分=部门
部门=部分
部署=摆设
部属=下属
擦过=掠过
猜测=推测
猜忌=猜疑
猜拳=豁拳
猜想=料想
才干=本领
才高八斗=学富五车
才华=才气
才能=才气
才气=才华
才人=秀士
材料=质料
财产=产业
财富=财产
财迷心窍=见利忘义
财气=财运
财务=财政
财源=财路
财政=财务
裁缝=成衣
裁减=淘汰
裁判员=评判员
裁员=裁人
采集=收罗
采纳=采取
采取=接纳
采用=接纳
参差不齐=乱七八糟
参观=观光
参加=到场
参见=拜见
参谋=顾问
参与=到场
残暴=暴虐
残害=践踏糟踏
残酷=暴虐
残缺=残破
残忍=暴虐
惭愧=内疚
惨淡=昏暗
惨痛=凄惨
惨无天日=天昏地暗
灿烂=辉煌光耀
仓促=匆匆
仓皇=仓促
仓库=堆栈
沧海一粟=九牛一毛
苍白=惨白
苍茫=迷茫
苍生=百姓
苍天=彼苍
操练=练习
操心=费心
操纵=利用
操作=操纵
草菅人命=滥杀无辜
草率=马虎
草莽=草泽
草木皆兵=杯弓蛇影
册封=封爵
侧重=偏重
厕所=茅厕
恻隐=怜悯
测量=丈量
测验=考试
策划=筹谋
策略=计谋
层次=条理
层次分明=井井有条
插手=加入
查办=核办
查访=察访
查核=考核
查看=检察
查问=盘问
茶房=跑堂
茶馆=茶室
茶楼=茶室
诧异=惊奇
差别=差异
差池=不对
差错=不对
差遣=驱使
差异=差别
搀杂=搀和
谗言=诽语
缠绵=缱绻
蝉联=连任
产品=产物
产业=财产
阐明=分析
阐述=论述
忏悔=后悔
颤动=颤抖
颤抖=颤动
昌盛=兴盛
猖獗=放肆
猖狂=放肆
长辈=尊长
长处=优点
长短=是非
长官=主座
长进=上进
长久=恒久
长命=长寿
长期=恒久
长驱直入=势如破竹
长生=永生
长寿=长命
长途=远程
长远=久远
长者=父老
长子=宗子
尝试=实验
偿还=归还
常常=经常
常规=通例
常人=凡人
常识=知识
场地=园地
场合=场所
场面=局面
场所=场合
畅快=痛快酣畅
畅所欲言=各抒己见
畅谈=泛论
畅通=流通
畅销=脱销
畅饮=痛饮
倡导=提倡
抄录=缮写
抄写=誊录
超过=凌驾
超级=超等
超逸=飘逸
超越=逾越
朝气=生机
朝气蓬勃=生机勃勃
朝秦暮楚=朝三暮四
朝三暮四=朝秦暮楚
朝夕=旦夕
朝阳=向阳
嘲讽=讽刺
嘲笑=讽刺
潮流=潮水
潮湿=湿润
潮水=潮流
吵架=打骂
吵闹=喧华
炒鱿鱼=卷铺盖
车水马龙=门庭若市
撤除=撤消
撤退=退却
撤销=打消
撤职=革职
尘埃=灰尘
尘间=凡间
尘世=凡间
尘土=灰尘
沉寂=寂静
沉浸=沉醉
沉沦=迷恋
沉没=淹没
沉迷=着迷
沉默=缄默沉静
沉睡=甜睡
沉重=极重
沉着=冷静
沉醉=陶醉
陈规=成规
陈设=摆设
陈述=报告
闯祸=肇事
闯入=突入
衬托=烘托
称号=称呼
称呼=称谓
称谓=称呼
称赞=歌颂
趁火打劫=攻其不备
趁机=乘隙
趁热打铁=一气呵成
趁早=赶早
成本=本钱
成长=发展
成分=身分
成功=乐成
成果=结果
成婚=结婚
成绩=结果
成家=立室
成见=偏见
成就=成绩
成立=建立
成品=制品
成亲=结婚
成全=玉成
成群结队=三五成群
成事在人=谋事在人
成天=整天
呈现=出现
承担=负担
承诺=答应
承认=认可
承受=蒙受
诚惶诚恐=坐卧不宁
诚恳=老实
诚实=老实
诚心=恳切
城市=都会
乘车=搭车
乘船=搭船
乘客=搭客
乘凉=纳凉
乘人之危=攻其不备
乘虚而入=攻其不备
惩办=惩治
惩罚=处罚
程度=水平
程序=步伐
吃醋=妒忌
吃饭=用饭
吃惊=受惊
吃苦=刻苦
吃亏=亏损
迟钝=痴钝
迟早=早晚
持久=长期
持续=连续
尺度=标准
耻辱=羞耻
耻笑=讥笑
叱呵=叱喝
叱咤风云=气吞山河
赤脚=光脚
充分=充实
充满=布满
充数=凑数
充足=富足
冲动=激动
冲锋陷阵=赴汤蹈火
冲毁=冲垮
冲击=打击
冲垮=冲毁
冲凉=洗沐
冲破=突破
冲入=突入
冲突=辩论
憧憬=向往
崇拜=崇敬
崇高=高贵
崇敬=崇拜
宠爱=痛爱
宠信=宠任
抽空=抽闲
抽泣=哭泣
抽烟=吸烟
仇恨=愤恨
仇家=对头
仇人=对头
仇视=敌视
惆怅=难过
愁眉不展=愁云满面
愁眉苦脸=没精打彩
愁闷=烦闷
愁云满面=愁眉不展
筹办=准备
筹备=筹办
筹划=操持
筹谋=策划
酬金=报答
酬劳=报酬
酬谢=报答
踌躇=犹豫
踌躇满志=意得志满
丑恶=丑陋
丑陋=貌寝
臭名=污名
臭名远扬=声名狼藉
出版=出书
出兵=发兵
出产=生产
出场=进场
出错=堕落
出格=特别
出力=着力
出面=出头
出名=着名
出奇制胜=声东击西
出人意表=出人意料
出入=收支
出色=精彩
出身=身世
出神=入迷
出声=作声
出事=失事
出手=脱手
出息=前程
出于无奈=必不得已
初步=开端
初春=早春
初级=低级
初一=月朔
初衷=初志
除暴安良=吊民伐罪
除掉=撤除
除去=撤除
锄奸=除奸
锄强扶弱=振弱除暴
储藏=蕴藏
储蓄=储备
处处=到处
处理=处置惩罚
处女=童贞
处事=办事
处死=正法
处所=地方
处心积虑=费尽心血
处置=处理
触犯=冒犯
触类旁通=举一反三
触目皆是=比比皆是
触怒=惹恼
矗立=耸立
揣测=臆测
揣度=推断
揣摩=推测
川流不息=络绎不绝
穿戴=穿着
传播=流传
传达=转达
传递=通报
传染=感染
传染病=流行症
传神=逼真
传授=教授
传颂=歌颂
传闻=听说
船员=海员
喘气=喘息
喘息=喘气
串连=勾通
串通=勾通
创办=开办
创立=建立
创始=首创
吹嘘=吹捧
垂老=老迈
垂怜=怜爱
垂青=看重
垂手可得=轻而易举
垂死=弥留
垂头=低头
垂头丧气=没精打采
垂危=告急
锤炼=磨炼
春风=东风
春景=春光
春联=对联
纯熟=熟练
纯真=单纯
蠢蠢欲动=摩拳擦掌
蠢人=笨伯
绰号=外号
词典=辞书
词藻=词采
慈爱=慈祥
慈善家=善士
慈祥=慈爱
辞别=告别
辞谢=推却
辞行=告别
雌雄=牝牡
此地无银三百两=欲盖弥彰
此后=今后
此刻=现在
此日=这天
此生=今生
此外=别的
次日=越日
次序=序次
刺耳=难听逆耳
刺骨=砭骨
刺目=刺眼
刺探=密查
刺眼=耀眼
赐给=赏给
赐教=见教
赐与=给予
从此=今后
从古到今=古往今来
从容自在=从容自若
从头=重新
从头到尾=从头至尾
从新=重新
从属=附属
匆匆=急忙
聪明=智慧
聪明一世=胡涂一时
丛林=森林
凑合=拼集
凑数=充数
粗略=大略
粗莽=卤莽
粗俗=卑鄙
粗言=鄙言
粗拙=粗糙
促膝谈心=把臂而谈
窜改=篡改
篡夺=夺取
篡改=窜改
催促=敦促
催讨=追讨
村落=乡村
村庄=乡村
村子=村落
存亡=生死
存心不良=包藏祸心
忖测=揣测
忖度=揣测
忖量=思念
寸步不离=跬步不离
寸草不留=鸡犬不留
磋商=商量
撮合=拉拢
挫折=波折
措辞=说话
措施=步伐
错爱=谬爱
错乱=庞杂
错落有致=犬牙交错
错杂=庞杂
搭车=乘车
搭船=乘船
搭救=援救
达成=告竣
达到=到达
达官贵人=王侯将相
答复=回复
答理=答应
答谢=报答
答应=允许
答允=答应
打扮=妆扮
打倒=打垮
打点=办理
打定=盘算
打动=感动
打斗=打架
打赌=赌钱
打盹=瞌睡
打狗不看主人面=罔顾情面
打坏=打碎
打诨=讥笑
打架=打斗
打劫=掠夺
打垮=打倒
打量=审察
打猎=狩猎
打骂=吵架
打破=冲破
打扰=打搅
打扫=扫除
打手势=打手式
打算=计划
打碎=打坏
打听=探询
打通=买通
打消=取消
打鱼=捕鱼
打针=注射
大白=明白
大败=大北
大半=泰半
大澈大悟=澈底觉悟
大盗=暴徒
大都=多数
大度=漂亮
大夫=医生
大富=豪富
大哥=年老
大喊=大呼
大好人=好人
大呼=大喊
大话=谎话
大家=各人
大驾=台端
大奸=巨猾
大将=上将
大叫=大呼
大举=大肆
大军=雄师
大快人心=民怨沸腾
大力=鼎力大举
大略=大抵
大骂=痛骂
大名=台甫
大难=浩劫
大难不死=劫后余生
大逆不道=犯上作乱
大年夜=年夜
大怒=震怒
大权在握=大权独揽
大煞风景=焚琴煮鹤
大声=高声
大师=大家
大势=局势
大水=洪流
大肆=放肆
大体=大要
大庭广众=稠人广众
大小=巨细
大雅=风雅
大言=狂言
大雨滂沱=大雨如注
大约=约莫
大贼=剧盗
大志=雄心
大致=大抵
大众化=普通化
大众文学=民间文学
大醉=烂醉陶醉
呆头呆脑=目瞪口呆
呆子=白痴
代办=代庖
代劳=代庖
代理=署理
代替=取代
带动=动员
带领=领导
待价而沽=囤积居奇
待遇=报酬
怠懈=怠惰
单刀赴会=单人独马
单方面=片面
单据=票据
单身=只身
单位=单元
单元=单位
单子=票据
担保=包管
担当=继承
担任=担当
担水=挑水
担忧=担心
耽搁=延误
耽误=延长
胆大心细=胆大心小
胆寒=胆怯
胆量=胆子
胆战心惊=提心吊胆
胆子=胆量
但愿=希望
弹琴=奏琴
弹丸之地=一矢之地
弹无虚发=百步穿杨
弹指之间=转瞬之间
蛋白=卵白
当兵=投军
当场=就地
当代=今世
当地=本地
当机不断=举棋不定
当即=立即
当局=政府
当令=适时
当面=劈面
当铺=寺库
当然=固然
当时=其时
当事者=本事儿
当真=认真
当作=看成
荡气回肠=勾魂摄魄
刀光剑影=刀光血影
导火线=引火线
倒背如流=滚瓜烂熟
倒戈=背叛
倒塌=坍毁
捣蛋=作怪
祷告=祈祷
到场=加入
到处=随处
到家=抵家
到手=得手
悼念=哀悼
盗匪=伏莽
盗汗=冷汗
盗窃=偷窃
盗取=偷取
道别=作别
道贺=庆贺
道教=玄门
道理=原理
道路=门路
道歉=致歉
道士=羽士
道听途说=耳食之闻
道谢=致谢
得病=抱病
得偿所愿=心满意足
得当=恰当
得救=解围
得意=自得
得罪=冒犯
德行=品德
德性=德行
的确=简直
灯火辉煌=灯烛辉煌
灯泡=灯胆
登峰造极=至高无上
登基=登位
登陆=登岸
登山=爬山
等待=等候
等到=比及
等第=品级
等分=平分
等候=期待
等级=品级
等闲=轻易
等于=即是
低落=低沉
滴水不漏=点水不漏
滴下=淌下
敌人=仇人
敌手=对手
底稿=稿本
底细=本相
底蕴=秘闻
底子=根本
抵偿=补偿
抵挡=抵抗
抵抗=反抗
抵赖=狡辩
抵御=抵抗
抵制=抵抗
地步=田地
地道=隧道
地点=所在
地动=地震
地方官=父母官
地盘=土地
地皮=地盘
地痞=流氓
地契=方单
地区=地域
地势=阵势
地图=舆图
地位=职位
地域=地区
地震=地动
地址=地点
地主=田主
弟妇=弟媳
弟媳=弟妇
弟子=门生
第三者=圈外人
第一流=最高级
缔造=创造
颠倒错乱=颠三倒四
巅峰=顶峰
典范=范例
典籍=文籍
典礼=仪式
典型=典范
点水不漏=滴水不漏
点头=颔首
点头答应=颔首应承
点缀=粉饰
电扇=风扇
电影=影戏
店铺=店肆
店员=伙计
店主=东家
玷辱=玷污
惦念=惦记
奠定=奠基
奠基=奠定
刁悍=强横
凋谢=凋落
碉堡=堡垒
雕残=凋零
雕虫小技=虫篆之技
雕刻=镌刻
雕零=雕落
雕落=雕零
吊儿郎当=好逸恶劳
吊祭=吊丧
吊颈=悬梁
吊水=打水
钓鱼=垂纶
调班=转班
调查=观察
调动=变更
调度=调理
调换=变更
调剂=调度
调节=调治
调侃=讥讽
调理=调治
调皮=淘气
调养=保养
调整=调解
掉包=偷换
掉队=落后
跌宕=跌荡
叮咛=吩咐
叮嘱=嘱咐
顶点=极点
顶用=中用
顶嘴=顶撞
鼎力=大力
鼎盛=壮盛
订婚=文定
订价=定价
订亲=订婚
定夺=决断
定价=订价
定亲=订婚
定数=定命
定心=放心
定义=界说
定罪=治罪
丢魂失魄=魂不附体
丢弃=抛弃
东奔西走=到处奔跑
东倒西歪=乱七八糟
东家=店主
东西=工具
东洋=东瀛
冬风=北风
冬眠=蛰伏
懂得=明白
动弹=转动
动静=消息
动人=感人
动人肺腑=沁人心脾
动听=动人
动员=发动
动作=行动
恫吓=恐吓
洞穴=窟窿
都会=都市
兜售=兜销
斗胆=大胆
斗殴=打斗
斗气=负气
斗志昂扬=意气风发
斗嘴=辩论
抖动=发抖
陡然=蓦地
豆浆=豆乳
豆蔻年华=及笄年华
豆芽=芽菜
逗留=停留
督工=管工
毒害=迫害
毒酒=鸩酒
毒杀=鸩杀
毒手=辣手
读书=念书
独霸=把持
独出机杼=别出心裁
独具匠心=别开生面
独身=单身
独特=奇特
独一=唯一
独有=独占
赌博=打赌
赌气=负气
赌钱=赌博
赌咒=起誓
肚量=襟怀
度日=过活
渡过=度过
渡水=涉水
端倪=眉目
端详=打量
短处=弊端
短文=漫笔
断魂=销魂
断绝往来=不相闻问
断命=毕命
断气=气绝
锻练=教练
锻炼=熬炼
锻造=铸造
堆积=聚集
队列=行列
队伍=步队
对比=比拟
对待=看待
对调=对换
对付=敷衍
对换=对调
对抗=反抗
对联=春联
对面=劈面
对手=敌手
对头=仇家
对象=工具
对奕=奕棋
对于=对付
对照=比较
对证=对质
对质=对证
对峙=坚持
对准=瞄准
敦促=鞭策
敦朴=敦厚
顿脚=跺脚
顿然=蓦地
顿时=马上
多半=多数
多此一举=节外生枝
多么=何等
多如牛毛=不足为奇
多少=几多
多事之秋=艰屯之际
多灾=多难
咄咄逼人=不可一世
哆嗦=颤抖
夺目=醒目
躲藏=潜藏
躲债=避债
堕胎=打胎
讹传=谣传
额外=分外
厄运=恶运
扼杀=抹杀
扼守=把守
恶毒心肠=狼心狗肺
恶搞=恶搞
恶贯满盈=罪不容诛
恶棍=无赖
恶疾=顽疾
恶梦=噩梦
恶人得势=歹徒横行
恶徒=暴徒
恶语伤人=出言无状
恶作剧=开玩笑
遏制=停止
恩仇=恩怨
恩典=恩情
恩情=膏泽
恩威并用=威德兼施
恩义=恩德
恩怨=恩仇
恩泽=膏泽
儿歌=童谣
儿女=后代
而后=尔后
而今=现在
而且=并且
而已=罢了
尔虞我诈=钩心斗角
耳环=耳饰
耳目=线人
耳J目染=目染耳濡
耳饰=耳环
耳提面命=谆谆教诲
发表=颁发
发兵=兴兵
发布=公布
发财=发达
发抖=抖动
发奋=发愤
发疯=发狂
发号施令=发号令
发火=生机
发家=发财
发酒疯=撒酒疯
发觉=觉察
发掘=掘客
发狂=发疯
发难=举事
发妻=嫡妻
发起=提倡
发烧=发热
发生=产生
发誓=立誓
发现=发明
发行=刊行
发芽=抽芽
发源=起源
发展=生长
伐罪=讨伐
法宝=宝贝
法场=刑场
法规=法例
法纪=纲纪
法例=法则
法令=法律
法律=执法
法门=秘诀
法式=程序
法术=术数
法网恢恢=天道好还
法眼=高眼
法则=规则
法子=办法
帆船=风帆
番薯=甘薯
翻江倒海=排山倒海
翻开=掀开
翻山越岭=跋山涉水
翻腾=翻滚
翻天覆地=排山倒海
翻译员=通译员
凡夫俗子=伧夫俗人
凡间=尘寰
凡是=通常
烦琐=嗦
烦厌=腻烦
烦躁=急躁
繁茂=茂盛
繁荣昌盛=繁荣富强
繁荣富强=繁荣昌盛
繁重=沉重
反常=变态
反对=阻挡
反复=重复
反复无常=朝三暮四
反攻=抨击
反悔=忏悔
反击=还击
反抗=抵抗
反客为主=反宾为主
反扑=反攻
反璞归真=洗净铅华
反响=回声
反应=反响
反映=反应
反照=倒映
反正=横竖
返来=归来回头
犯错=出错
犯得上=犯得着
犯得着=犯得上
犯科=不法
犯人=监犯
犯罪=犯法
泛泛=平常
泛起=出现
饭店=饭馆
饭馆=饭店
饭桶=脓包
范畴=领域
范例=典范
范围=范畴
贩子=市井
方才=刚刚
方法=要领
方式=方法
方向=偏向
方圆=周遭
方针=目标
方子=方剂
芳华=青春
防备=预防
防范=防备
防线=防地
防御=防备
防止=防备
妨害=波折
房契=宅券
房屋=衡宇
房子=屋子
仿佛=好像
仿照=模仿
访友=探友
彷徨=徘徊
放荡=纵脱
放火=纵火
放哨=巡查
放肆=放荡
放下屠刀=改邪归正
放置=安排
放逐=充军
飞驰=飞奔
飞腾=高潮
飞舞=飞翔
飞翔=翱翔
飞跃=奔腾
非凡=特殊
非命=横死
非死即伤=不死即伤
蜚短流长=闲言闲语
蜚言=浮言
蜚语=流言
废除=破除
废话=空话
废料=废物
费尽唇舌=舌敝唇焦
费尽心机=久有存心
费神=费心
费心=操心
费用=用度
分辨=辨别
分布=漫衍
分担=分管
分割=支解
分隔=分开
分伙=散伙
分家=分居
分解=剖析
分居=分家
分开=离开
分离=分散
分裂=破裂
分泌=排泄
分娩=临盆
分秒必争=争分夺秒
分明=明白
分派=分配
分配=分派
分散=疏散
分身=两全
分身乏术=分身不暇
分手=分离
分说=辩白
分庭抗礼=不相上下
分外=特别
分文不取=一钱不受
分析=阐发
吩咐=付托
纷乱=庞杂
纷歧=不一
纷扰=骚动
纷至沓来=络绎不绝
芬芳=芳香
氛围=气氛
坟场=墓地
坟墓=宅兆
焚杀=屠烧
焚烧=点火
粉墨登场=袍笏登场
粉身碎骨=赴汤蹈火
粉饰=遮盖
粉碎=破坏
奋不顾身=不屈不挠
奋斗=搏斗
奋发=高昂
奋发图强=奋发蹈厉
奋发向上=奋发图强
奋起=抖擞
奋起直追=急起直追
愤恨=恼恨
愤懑=怨愤
愤怒=恼怒
丰采=神姿
丰度=品貌
丰富=富厚
丰功伟绩=劳苦功高
丰厚=丰盛
丰满=饱满
丰硕=丰富
丰衣足食=人给家足
丰裕=充裕
风波=风浪
风采=风范
风餐露宿=跋山涉水
风尘仆仆=栉风沐雨
风驰电掣=追风逐电
风度=风采
风度翩翩=风姿潇洒
风帆=帆船
风范=风采
风格=气势派头
风光=风景
风景=风物
风卷残云=狼吞虎咽
风浪=风波
风凉=凉爽
风流=风骚
风马牛不相及=风马不接
风貌=风采
风平浪静=海不扬波
风起云涌=汹涌澎拜
风气=民风
风趣=滑稽
风扇=电扇
风尚=风俗
风声鹤唳=土崩瓦解
风俗=民俗
风行=流行
风行一时=不胫而走
风言风语=飞短流长
风雨飘摇=岌岌可危
风雨同舟=休戚相关
风韵=风姿
风筝=鹞子
风烛残年=行将就木
封闭=关闭
封爵=册封
封锁=封闭
疯狂=猖獗
烽火=狼烟
锋利=尖锐
蜂拥=簇拥
逢场作戏=游戏人间
逢凶化吉=化险为夷
逢迎=投合
缝隙=漏洞
讽刺=讥笑
凤毛麟角=百里挑一
奉承=逢迎
奉告=告知
奉还=璧还
奉命=衔命
奉陪=作陪
奉劝=劝告
奉上=送上
奉行=推行
奉养=服侍
奉迎=讨好
佛教=释教
佛门=空门
否定=否认
否极泰来=时来运转
否决=反对
否认=否定
否则=不然
夫唱妇随=鹿车共挽
夫妇=匹俦
夫君=良人
夫妻=伉俪
肤浅=菲薄
敷衍=搪塞
敷衍了事=马马虎虎
伏法=伏诛
伏枥老骥=归隐志士
伏诛=伏法
伏罪=服罪
扶养=抚养
扶摇直上=百尺竿头
扶助=帮助
拂面=掠面
拂拭=扫除
拂晓=破晓
拂袖=拂衣
服从=听从
服毒=仰药
服法=吃法
服气=佩服
服侍=奉养
服饰=衣饰
服帖=帖服
服务=办事
服装=打扮
服罪=伏罪
浮光掠影=走马看花
浮夸=夸诞
浮名=谰言
浮浅=菲薄
浮现=表现
浮言=蜚言
浮躁=暴躁
符号=标记
符合=切合
福分=福气
福祸=休咎
福气=福分
福寿无疆=福寿绵绵
抚琴=弹琴
抚玩=观赏
抚慰=安慰
抚心=扪心
抚养=扶养
抚育=抚养
府上=贵寓
俯拾即是=俯拾地芥
辅导=领导
辅助=帮助
辅佐=帮手
腐败=糜烂
腐烂=腐败
腐蚀=腐化
腐朽=腐败
父母=怙恃
父母官=地方官
付出=支付
负担=包袱
负疚=抱歉
负气=使气
负心=亏心
负约=失期
负责=卖力
负债=欠债
附和=赞同
附近=四周
附属=隶属
复活=复生
复苏=苏醒
复习=温习
复兴=再起
复原=回复
复杂=庞大
赴汤蹈火=出生入死
副手=帮手
富贵=繁华
富可敌国=金玉满堂
富丽=华丽
富强=茂盛
富商=巨贾
富翁=大亨
富裕=富饶
富足=富裕
赋税=钱粮
赋闲=失业
腹地=要地
覆盖=笼罩
覆没=淹没
覆水难收=反水不收
该当=应当
该死=活该
改扮=乔妆
改动=窜改
改革=革新
改观=变动
改过自新=洗心革面
改换=更换
改嫁=再醮
改进=革新
改良=改进
改名=更名
改期=脱期
改日=他日
改善=改进
改头换面=洗面革心
改行=转业
改造=改革
改正=纠正
盖章=盖印
盖住=挡住
概况=表面
概括=归纳综合
概略=大要
概念=观点
概要=提要
干脆=爽性
干爹=寄父
干戈=兵戈
干涸=干枯
干劲=劲头
干净=洁净
干枯=凋谢
干连=扳连
干练=老练
干娘=谊母
干扰=滋扰
干涉=干预干与
干事=做事
干预=干涉
甘拜下风=心悦诚服
甘心=甘愿宁可
甘愿=宁愿
肝胆相照=坦怀相待
肝火=怒气
肝脑涂地=粉身碎骨奋不顾身
尴尬=难堪
赶紧=赶快
赶快=赶紧
赶忙=赶快
赶上=遇上
赶早=趁早
感触=感慨
感到=感触
感德=戴德
感动=冲动
感恩=戴德
感恩图报=结草衔环
感化=作用
感激=感谢
感激不尽=感激涕零
感激涕零=感激不尽
感慨=感触
感冒=伤风
感情=情感
感染=熏染
感人=动人
感伤=感慨
感受=感觉
感叹=叹息
感想=感触
感谢=谢谢
感应=感到
刚愎自用=独断专行
刚才=适才
刚刚=方才
刚好=恰好
刚烈=刚强
刚强=坚强
刚巧=恰巧
刚毅=坚毅
刚正=朴直
刚直=朴直
岗位=岗亭
纲领=大纲
纲要=纲领
港口=口岸
高昂=奋发
高傲=自豪
高卑=崎岖
高超=高明
高潮=热潮
高出=超过
高大=高峻
高档=高等
高低=崎岖
高峰=岑岭
高高在上=高屋建瓴
高贵=高尚
高见=卓识
高利贷=印子钱
高慢=高傲
高妙=高明
高明=高超
高攀=攀附
高朋满座=宾朋盈门
高人一等=头角峥嵘
高尚=崇高
高深=高妙
高声=大声
高手=妙手
高谈阔论=放言高论
高屋建瓴=高高在上
高兴=兴奋
高雅=雅致
高招=高着
高枕无忧=安枕无忧
搞乱=搅散
告白=广告
告别=离别
告辞=告别
告发=告密
告急=紧急
告假=请假
告捷=得胜
告诫=申饬
告老还乡=辞职归里
告密=密告
告示=通告
告诉=报告
告退=辞职
告知=见告
告状=起诉
告罪=陪罪
戈壁=沙漠
割断=切断
割据=盘据
割裂=分裂
搁笔=停笔
搁浅=停顿
搁置=弃捐
歌唱=歌颂
歌女=女乐
歌颂=赞美
歌咏=歌颂
阁下=左右
革退=斥革
革新=改造
革职=免职
格斗=搏斗
格格不入=I格难入
格局=格式
格外=分外
隔岸观火=冷眼旁观
隔壁=隔邻
隔断=隔绝
隔阂=隔膜
隔绝=阻遏
隔开=离隔
隔离=断绝
隔膜=隔阂
隔山观虎斗=漠不关心
个别=个体
个人=小我私家
个人主义=本位主义
个体=个别
个性=本性
个中=其中
各尽所能=各展其长
各类=各种
各人=大家
各色各样=林林总总
各抒己见=知无不言
各位=列位
各行其是=各自进行
各样=百般
各有千秋=半斤八两
各执己见=互不相让
各执一词=各不相谋
各种=种种
各种各样=林林总总
各自为政=各不相谋
给以=赐与
给予=赐与
根本=基础
根除=革除
根基=基本
根据=凭据
根源=泉源
跟班=跟从
跟从=跟随
跟随=追随
跟尾=衔接
跟着=随着
更改=变动
更换=调换
更加=越发
更甚=愈甚
更生=重生
更衣=换衣
更正=改正
耕田=种田
耕耘=耕作
耕种=耕作
耕作=耕耘
耿耿于怀=铭心镂骨
工厂=工场
工夫=光阴
工具=东西
工钱=人为
工头=领班
工业=产业
工整=工致
工资=人为
工作=事情
弓手=射手
公布=宣布
公道=公正
公而忘私=大公无私
公愤=众怒
公告=通告
公共=大众
公共场所=公开场合
公馆=第宅
公函=公文
公家=公众
公开=公然
公开场合=大庭广众
公理=正义
公民=百姓
公判=公审
公平=公正
公然=果然
公审=公判
公事=公务
公文=公牍
公务=公事
公约=条约
公正=公平
公证人=评判人
公众=民众
公子=令郎
公子哥儿=膏粱子弟
公子王孙=纨髯拥
功败垂成=半途而废
功臣=元勋
功成身退=知难而退
功德=好事
功夫=工夫
功绩=功劳
功课=作业
功亏一篑=半途而废
功劳=劳绩
功名利禄=富贵荣华
功能=功效
功效=成果
功勋=功绩
功用=服从
攻击=打击
攻克=霸占
攻其不备=趁火打劫
攻无不克=百战百胜
攻下=攻陷
攻陷=霸占
供不应求=求过于供
供词=口供
供给=供应
供认=招供
供养=扶养
供应=供给
恭恭敬敬=必恭必敬
恭敬=敬重
恭顺=恭敬
恭维=阿谀
巩固=牢固
共谋=同谋
共识=共鸣
共同=配合
共同努力=通力合作
贡献=孝敬
勾串=勾通
勾搭=勾结
勾当=活动
勾结=勾通
沟通=相同
狗急跳墙=垂死挣扎
狗仗人势=驴蒙虎皮
苟且=轻易
苟且偷生=得过且过
构成=组成
构思=构想
构想=构思
构造=结构
购买=购置
购置=购买
估计=预计
估量=估计
姑娘=女人
姑且=临时
姑息=迁就
姑息养奸=养虎遗患
孤傲=孤独
孤单=孑立
孤独=孤单
孤芳自赏=自命不凡
孤高=高慢
孤家寡人=孤苦伶仃
孤军作战=单刀赴会
孤苦=孤独
孤苦伶仃=孤家寡人
孤立=伶仃
孤陋寡闻=目光如豆
孤僻=孤介
孤掌难鸣=独木难支
孤注一掷=背注一掷
古板=死板
古道热肠=古貌古心
古董=骨董
古怪=离奇
古迹=奇迹
古老=陈腐
古人=昔人
古往今来=从古到今
骨干=主干
骨气=节气
骨肉=骨血
骨肉相残=兄弟阋墙
蛊惑=勾引
鼓吹=宣扬
鼓动=鞭策
鼓励=勉励
鼓起=兴起
鼓舞=鼓动
鼓掌=拍手
固步自封=抱残守缺
固定=牢固
固然=虽然
固若金汤=坚如盘石
固守=恪守
固执=顽强
故步自封=抱残守缺
故国=祖国
故交=故友
故居=故宅
故里=故乡
故人=故交
故乡=故里
故意=存心
故障=妨碍
顾此失彼=左支右绌
顾忌=忌惮
顾客=主顾
顾虑=挂念
顾问=照料
顾主=主顾
雇用=招聘
雇主=店主
瓜分=朋分
瓜葛=扳连
刮风=起风
刮目相看=另眼相看
寡不敌众=众寡不敌
寡妇=未亡人
挂彩=挂花
挂号=登记
挂念=顾虑
挂心=挂记
乖巧=灵巧
拐骗=诱骗
拐弯抹角=含沙射影
拐杖=手杖
怪诞=荒诞
怪僻=古怪
怪异=独特
关闭=封闭
关怀=眷注
关键=要害
关节=枢纽
关口=关隘
关连=干系
关切=关怀
关系=干系
关心=体贴
关照=看护
关注=存眷
观测=观察
观察=视察
观点=看法
观光=旅行
观看=寓目
观念=看法
观赏=抚玩
观望=张望
官逼民反=铤而走险
官场=政界
官价=公价
官吏=仕宦
官僚=权要
官署=官厅
官司=讼事
冠冕堂皇=堂而皇之
管理=治理
管辖=统领
管制=管束
贯穿=贯串
贯串=贯穿
贯通=领悟
惯例=老例
惯用=习用
灌溉=浇灌
灌输=贯注
光彩=色泽
光复=规复
光顾=惠顾
光怪陆离=千奇百怪
光棍=王老五骗子
光华=光彩
光滑=平滑
光辉=灿烂
光降=来临
光景=风景
光亮=光明
光临=到临
光芒=光线
光明=灼烁
光明磊落=正大光明
光明正大=大公至正
光荣=庆幸
光说不练=言而不行
光说不做=言而不行
光天化日=青天白日
光头=秃顶
光秃秃=光溜溜
光鲜=鲜明
光线=光芒
光耀=灿烂
光阴=时光
光阴似箭=白驹过隙
光泽=光芒
广博=博识
广大=宽大
广泛=遍及
广告=告白
广阔=辽阔
广漠=广阔
犷悍=蛮横
逛逛=走走
归国=返国
归还=送还
归咎=归罪
归来=返来
归去=回去
归天=去世
归途=归程
规定=划定
规范=范例
规规矩矩=规行矩步
规划=计划
规矩=端正
规律=纪律
规模=范围
规则=规矩
闺房=内室
瑰宝=宝贝
瑰丽=美丽
诡计=企图
鬼斧神工=巧夺天工
鬼怪=鬼魅
鬼鬼祟祟=偷偷摸摸
鬼话=大话
鬼魂=幽灵
鬼混=厮混
鬼火=磷火
鬼哭神号=天愁地惨
鬼魅=鬼怪
鬼门关=地府
鬼迷心窍=鬼摸脑壳
鬼使神差=阴差阳错
贵宾=高朋
贵客=高朋
贵人=朱紫
贵姓=尊姓
贵重=珍贵
跪拜=膜拜
滚蛋=滚开
滚动=转动
滚瓜烂熟=倒背如流
滚滚=滔滔
滚开=滚蛋
滚水=沸水
国粹=国学
国都=都城
国法=王法
国家=国度
国家栋梁=中流砥柱
国界=版图
国民=百姓
国内=海内
国色天香=天姿国色
国是=国事
国土=领土
国外=外洋
国学=国粹
国贼=民贼
果断=坚决
果腹=充饥
果敢=大胆
果然=公然
果真=果然
裹足=扎脚
裹足不前=停滞不前
过程=历程
过错=不对
过度=过分
过分=太过
过河拆桥=不知恩义
过河抽板=不知恩义
过后=事后
过火=偏激
过目不忘=过目成诵
过期=逾期
过去=已往
过甚=过头
过失=不对
过时=过期
过问=干涉
过夜=留宿
过犹不及=矫枉过正
海底捞针=杳如黄鹤
海涵=包涵
海军=水师
海枯石烂=天长地久
海阔天空=天南地北
海浪=波浪
海内=国内
海市蜃楼=梦幻泡影
海誓山盟=天长地久
海外=外洋
海域=海疆
骇人听闻=耸人听闻
害怕=畏惧
害人不浅=贻害不浅
害臊=怕羞
害羞=含羞
酣畅=畅快
憨厚=敦朴
含恨=抱恨
含糊=暗昧
含糊其词=模棱两可
含沙射影=暗箭伤人
含笑=浅笑
含笑九泉=含笑入地
含辛茹苦=历尽艰辛
含羞=怕羞
含蓄=蕴藉
含血喷人=含沙射影
含义=寄义
含冤=抱屈
函件=翰札
涵养=修养
寒冬=隆冬
寒风=北风
寒光=冷光
寒冷=严寒
寒气=冷气
寒暄=交际
罕见=稀有
罕用=少用
罕有=罕见
汉文=华文
汉子=男人
汗流浃背=汗出如浆
汗如雨下=汗流浃背
汗衫=笠衫
悍妇=泼妇
捍卫=保卫
航海=帆海
航行=飞行
毫不=绝不
豪放=豪迈
豪杰=好汉
豪迈=豪放
豪门=权门
豪气=英气
豪爽=豪迈
好本领=好身手
好比=比如
好菜=佳肴
好处=利益
好多=很多多少
好管闲事=多事生非
好汉=豪杰
好坏=优劣
好景不常=昙花一现
好久=很久
好看=悦目
好梦=美梦
好人难做=善门难开
好身手=好本领
好生之德=慈悲心肠
好事=功德
好事多磨=鲜花易谢
好手=妙手
好似=恰似
好天=晴天
好像=似乎
好笑=可笑
好心=美意
好学=勤学
好意=美意
好友=挚友
好在=幸亏
号角=军号
号令=命令
号召=招呼
浩大=浩荡
浩荡=浩大
浩瀚=众多
浩浩荡荡=声势赫赫
浩劫=大难
耗费=泯灭
耗损=消耗
呵叱=呵斥
呵斥=呵叱
呵护=庇护
喝采=喝彩
喝彩=喝采
喝茶=品茗
合并=归并
合法=正当
合格=及格
合伙=合资
合理=公道
合力=协力
合谋=同谋
合情合理=通情达理
合身=称身
合时=适时
合适=符合
合同=条约
合用=适用
合作=互助
何必=何须
何处=那边
何等=多么
何干=何关
何故=何以
何堪=那堪
何况=况且
何为=作甚
何须=何必
何在=安在
和蔼=平和
和蔼可亲=蔼然可亲
和好=和洽
和解=息争
和盘托出=尽情宣露
和平=宁静
和气=和睦
和洽=和好
和善=和蔼
和尚=僧人
和事老=鲁仲连
和顺=温顺
和谐=调和
和煦=暖和
河边=河滨
河道=河流
河流=河道
河畔=河边
河山=国土
核办=查究
核定=审定
核对=查对
核心=焦点
核准=批准
贺年=拜年
贺喜=道喜
赫赫有名=大名鼎鼎
鹤立鸡群=佼佼不群
黑暗=暗中
黑白=好坏
黑白不分=善恶不分
黑沉沉=阴森森
黑点=斑点
黑货=私货
黑幕=内幕
黑钱=陋规
黑色=玄色
黑市=暗盘
黑压压=黑糊糊
痕迹=陈迹
很多=许多
很久=好久
很是=非常
狠毒=毒辣
恨之入骨=恨入骨髓
恒久=长期
横暴=蛮横
横跨=高出
横三竖四=颠三倒四
横死=非命
横行霸道=胡作非为
衡量=权衡
轰动=惊动
轰轰烈烈=大张旗鼓
哄骗=利用
哄人=骗人
烘托=陪衬
红尘=尘世
红军=赤军
红色=赤色
红杏出墙=不安于室
红颜=朱颜
红颜薄命=美人命薄
宏大=弘大
宏亮=嘹亮
宏伟=雄伟
宏愿=大志
洪亮=嘹亮
洪水=大水
鸿鹄之志=青云之志
鸿图=鸿猷
鸿运=隆运
后辈=子弟
后代=子女
后盾=后援
后果=结果
后悔=悔恨
后记=跋文
后来=厥后
后来居上=青出于蓝
后面=背面
后生可畏=少年老成
后世=后代
后台=背景
后头=背面
后退=退却
后裔=后代
后援=后盾
厚待=厚遇
厚道=老实
厚利=重利
厚实=丰富
厚颜无耻=恬不知耻
厚遇=厚待
呼喊=呼唤
呼唤=召唤
呼叫=呼唤
呼啸=咆哮
呼吁=号令
忽冷忽热=乍寒乍热
忽然=突然
狐臭=腋臭
狐假虎威=仗势欺人
狐媚=媚惑
胡里胡涂=浑浑噩噩
胡闹=厮闹
胡说=乱说
胡说八道=颠三倒四
胡思乱想=妙想天开
胡涂一时=聪明一世
胡须=髯毛
胡言乱语=颠三倒四
胡作非为=横行霸道
糊口=生活
糊弄=乱来
虎豹=豺狼
虎将=猛将
虎头蛇尾=有头无尾
互不侵犯=各不相犯
互不相让=各执己见
互换=交换
互相=相互
互助=相助
护理=照顾护士
护卫=保护
花白=斑白
花草=花卉
花费=耗费
花花世界=十丈软红
花卉=花草
花名=混名
花前月下=月下花前
花钱=费钱
花容月貌=闭月羞花
花天酒地=灯红酒绿
花团锦簇=五彩缤纷
花纹=斑纹
花言巧语=甜言蜜语
花样=格式
花园=花圃
花枝招展=浓妆艳抹
华而不实=脆而不坚
华丽=富丽
华美=华丽
华山=西岳
华陀再世=药到病除
华夏=中原
哗变=叛变
哗笑=喧笑
滑冰=溜冰
滑稽=风趣
滑腻=光滑
化为乌有=子虚乌有
化险为夷=转败为功
化妆=化装
化装=扮装
划船=荡舟
划定=规定
划分=分别
画饼充饥=割肉医疮
画龙点睛=一语道破
画蛇添足=多此一举
画图=绘图
话柄=口实
话不投机=交浅言深
话筒=发话器
怀抱=度量
怀恨=挟恨
怀念=吊唁
怀胎=妊娠
怀疑=猜疑
怀孕=有身
坏处=弊端
坏话=浮名
坏人=暴徒
欢畅=欢快
欢快=高兴
欢乐=高兴
欢腾=高兴
欢天喜地=眉飞色舞
欢喜=欢乐
欢欣=欢乐
欢欣鼓舞=兴高采烈
欢迎=接待
欢悦=欢腾
欢跃=欢腾
还击=反击
还是=照旧
还乡=回籍
还有=另有
环抱=环绕
环顾=环视
环境=情况
环球=举世
环绕=围绕
环视=环顾
环游=周游
缓步=漫步
缓和=和缓
缓缓=徐徐
缓慢=迟钝
缓期=脱期
幻境=幻梦
幻术=把戏
幻想=理想
宦官=阉人
唤醒=叫醒
换班=调班
换取=调换
换衣=易服
涣然一新=面目全非
涣散=分散
患病=抱病
患难=磨难
患难夫妻=同命鸳鸯
焕发=抖擞
荒诞=怪诞
荒诞不经=荒谬绝伦
荒废=疏弃
荒凉=荒芜
荒谬=谬妄
荒谬绝伦=荒诞不经
荒漠=荒原
荒僻=偏僻
荒唐=荒诞
荒芜=荒凉
荒野=荒原
荒淫无度=荒淫无耻
荒原=荒野
慌慌张张=丢魂失魄
慌乱=忙乱
慌忙=匆忙
慌张=张皇
皇帝=天子
黄灿灿=金灿灿
黄昏=薄暮
黄历=通书
黄粱一梦=南柯一梦
黄泉=鬼域
惶惶=惶遽
惶惶不安=胆战心惊
惶恐=惊骇
恍惚=模糊
恍然大悟=名顿开
晃荡=晃悠
谎话=大话
谎言=谎话
灰暗=昏暗
灰尘=尘土
灰心=悲观
灰心丧气=暮气沉沉
诙谐=幽默
恢复=规复
挥动=摆荡
挥挥手=招招手
挥霍=浪费
挥霍无度=挥金如土
挥泪=洒泪
挥洒自如=笔底生花
挥舞=挥动
辉煌=光辉
回答=答复
回复=复兴
回覆=回答
回顾=回首
回国=返国
回击=回手
回绝=谢绝
回扣=背工
回来=返来
回去=归去
回身=转身
回收=接纳
回首=回顾
回天乏术=无法复生
回头=转头
回头是岸=悬崖勒马
回响=反响
回想=追念
回心=转意
回心转意=改变主张
回信=复书
回旋=盘旋
回忆=回想
回音=覆信
悔改=改过
悔过=悔悟
悔恨=痛恨
悔悟=悔过
汇报=报告
汇合=会合
汇集=搜集
会餐=聚餐
会萃=聚集
会合=会集
会集=会合
会计=管帐
会见=访问
会面=碰面
会谈=谈判
会晤=会面
会议=集会
会意=会心
讳饰=遮掩
绘声绘色=栩栩如生
绘图=画图
荟萃=集合
贿赂=行贿
晦暗=昏暗
晦气=不利
晦涩=艰涩
惠顾=光顾
惠临=光临
毁谤=诋毁
毁坏=破坏
毁灭=扑灭
昏暗=惨淡
昏倒=昏迷
昏厥=昏迷
昏迷=昏倒
昏迷不醒=不省人事
婚事=亲事
浑浑噩噩=胡里胡涂
浑朴=浑厚
浑然一体=十全十美
浑身=满身
浑水摸鱼=乘虚而入
浑浊=污浊
魂不附体=丢魂失魄
魂不守舍=漫不经心
魂飞魄散=六神无主
魂灵=灵魂
魂魄=灵魂
混蛋=忘八
混合=混淆
混混=地痞
混乱=杂乱
混身=满身
混水摸鱼=浑水摸鱼
混为一谈=等量齐观
混淆=ピ
混淆黑白=颠倒黑白
混淆视听=混淆黑白
混杂=稠浊
混浊=浑浊
豁达=豪迈
豁免=宽免
活动=运动
活该=该死
活灵活现=活龙活现
活路=生路
活埋=生坑
活泼=生动
活跃=活泼
活着=在世
火柴=洋火
火锅=暖锅
火急=迫切
火警=火灾
火炬=火把
火上浇油=推波助澜
火烧眉毛=迫不及待
火速=敏捷
火药=炸药
火灾=火警
火葬=火化
伙伴=同伴
伙计=店员
伙食=炊事
或许=大概
或者=大概
货币=钱币
货物=货品
获得=得到
获救=得救
获利=赢利
获胜=得胜
获罪=开罪
祸不单行=灾患丛生
祸从口出=祸发齿牙
祸端=祸根
祸根=祸端
祸国殃民=病国殃民
祸害=祸患
祸患=祸殃
祸乱滔天=沧海横流
祸首=罪魁
讥讽=挖苦
讥笑=讽刺
击鼓=伐鼓
饥不择食=寒不择衣
饥寒交迫=啼饥号寒
机关=构造
机会=时机
机警=机灵
机灵=机敏
机密=秘密
机敏=机灵
机能=性能
机器=呆板
机械=机器
机要=秘密
机遇=机会
机缘=机遇
机智=机警
鸡飞狗跳=鸡飞狗走
鸡零狗碎=琐屑零星
鸡犬不宁=鸡飞狗跳
鸡犬升天=一人得道
积储=积蓄
积存=积蓄
积德=行善
积聚=积累
积累=积聚
积少成多=集腋成裘
积习难改=积重难返
积蓄=积贮
积压=积存
基本=根本
基层=下层
基础=底子
缉捕=捉拿
稽查=稽察
稽察=稽查
稽核=考核
激昂=鼓动
激荡=荡漾
激动=冲动
激发=引发
激愤=激怒
激励=鼓励
激烈=猛烈
激怒=激愤
激情=豪情
激战=鏖战
羁绊=拘束
及格=合格
及时=实时
及早=赶早
吉利=吉祥
吉人天相=善者神佑
吉日=谷旦
吉祥=祥瑞
吉凶=休咎
吉兆=佳兆
岌岌可危=间不容发
汲取=罗致
即刻=马上
即日=克日
即使=纵然
即是=便是
极点=顶点
极度=非常
极端=极度
极乐世界=神仙世界
极力=尽力
极少=少少
极刑=死罪
急变=遽变
急不可待=岌岌可危
急促=仓促
急急=仓促
急急忙忙=快快当当
急救=抢救
急流=激流
急流勇退=功成身退
急忙=急遽
急忙忙=急乎乎
急迫=迫切
急起直追=奋起直追
急切=火急
急躁=暴躁
急中生智=情急智生
疾驰=奔驰
疾苦=痛苦
疾走=狂奔
集合=聚集
集会=聚会会议
集思广益=群策群力
集体=团体
集团=团体
集腋成裘=聚沙成塔
集中=会合
嫉妒=妒忌
几次=频频
几多=多少
几何=多少
几乎=险些
几回=几次
几许=多少
计策=计谋
计划=筹划
计较=计算
计谋=战略
计算=盘算
计帐=算帐
记挂=挂念
记号=暗号
记录=记载
记取=记着
记实=记录
记忆=影象
记忆犹新=念念不忘
记载=纪录
记住=记着
记着=记取
伎俩=本领
纪录=记录
纪律=规律
纪念=怀念
妓院=倡寮
忌辰=忌日
忌惮=顾忌
忌讳=隐讳
忌日=忌辰
技俩=款式
技巧=本领
技术=技能
技艺=武艺
际遇=境遇
季节=季候
继承=继续
继往开来=承前启后
继续=继承
继续不停=络绎不绝
寂静=沉寂
寂寥=寥寂
寂寞=寥寂
寄居=借居
寄人篱下=俯仰由人
寄宿=投止
寄托=拜托
寄望=留意
祭奠=祭祀
祭祀=祭奠
加倍=更加
加害=侵犯
加快=加速
加强=增强
加入=参加
加速=加快
夹杂=混合
佳话=韵事
佳丽=美人
佳偶=匹俦
佳偶天成=嘉偶天成
佳人=美人
佳肴=好菜
家产=产业
家常便饭=屡见不鲜
家传=祖传
家当=产业
家丁=仆人
家境=家景
家眷=家属
家徒四壁=贫无立锥
家乡=故乡
家信=家书
家园=故里
家属=眷属
家族=家属
嘉宾=高朋
嘉奖=夸奖
价格=代价
价钱=价格
价值=代价
价值连城=价值千金
驾轻就熟=得心应手
驾驭=驾御
架空=排挤
假充=冒充
假公济私=营私舞弊
假话=谎言
假货=赝品
假冒=冒充
假名=化名
假票=伪钞
假仁假义=假装好人
假日=沐日
假如=如果
假若=倘使
假使=倘使
假意=冒充
假造=捏造
假装=冒充
嫁祸=移祸
嫁妆=妆奁
奸棍=奸徒
奸滑=奸诈
奸狡=奸刁
奸商=市侩
奸细=特工
奸险=刁滑
奸笑=狞笑
奸淫=奸骗
奸诈=刁滑
尖刻=刻薄
尖利=尖锐
尖锐=锋利
尖酸=刻薄
尖酸刻薄=繁言吝啬
坚不可摧=坚如盘石
坚持=对峙
坚持不懈=坚韧不拔
坚持到底=贯彻始终
坚定=刚强
坚定不移=百折不挠
坚固=结实
坚决=果断
坚苦=困难
坚苦卓绝=历尽艰辛
坚强=刚强
坚忍=坚固
坚韧=坚固
坚韧不拔=坚持不懈
坚如盘石=固若金汤
坚实=坚固
坚守=服从
坚毅=坚贞
坚毅不拔=威武不屈
坚毅刚烈=刚正
坚硬=坚固
坚贞=坚忍
坚贞不屈=傲雪欺霜
歼灭=扑灭
间不容发=岌岌可危
间谍=特工
间断=中断
间隔=隔断
肩负=负担
艰巨=困难
艰苦=费力
艰苦朴素=勤勤俭俭
艰难=艰巨
艰涩=晦涩
艰深=深邃
艰辛=艰苦
兼并=吞并
兼顾=分身
监督=监视
监犯=犯人
监管=羁系
监禁=羁系
监牢=缧绁
监视=监督
监狱=牢狱
缄口=闭口
缄口不言=默不作声
缄默=沉默
俭朴=朴实
减价=跌价
减弱=削弱
减少=淘汰
减削=节减
减刑=弛刑
剪刀=铰剪
剪发=剃头
检查=查抄
检察=查察
检点=检核
检核=检点
检讨=检验
检修=检验
检验=查验
检阅=校阅
简便=轻便
简单=简朴
简洁=简便
简捷=简便
简练=简洁
简陋=大略
简略=大略
简朴=简单
简要=扼要
简易=浅易
见地=看法
见多识广=博古通今
见风使舵=见机行事
见怪=见责
见机=识趣
见机行事=见风使舵
见解=看法
见利忘义=不知恩义
见谅=包涵
见面=晤面
见识=见地
见识浅短=少见多怪
见死不救=漠不关心
见闻广博=博古通今
见效=收效
见义勇为=当仁不让
见异思迁=喜新厌旧
建功=立功
建国=开国
建立=创建
建设=建立
建树=建立
建议=发起
建造=制作
建筑=修建
贱卖=平沽
健康=康健
健忘=忘记
健壮=结实
渐渐=徐徐
践踏=蹂躏
鉴别=辨别
鉴定=判定
鉴赏=观赏
江河日下=一落千丈
江山=山河
将近=快要
将就=迁就
将来=未来
僵持=对峙
疆场=战场
疆土=版图
疆域=领土
讲错=失言
讲和=媾和
讲话=发言
讲价=论价
讲解=解说
讲究=讲求
讲课=授课
讲明=表明
讲求=考究
讲授=教学
讲述=报告
讲义=课本
奖惩=赏罚
奖励=嘉奖
奖赏=夸奖
匠心独运=别开生面
降低=低落
降价=贬价
降临=到临
降生=诞生
交叉=交织
交错=交织
交代=交接
交锋=比武
交换=互换
交际=外交
交接=交代
交界=接壤
交流=交换
交情=友爱
交融=融会
交涉=谈判
交手=比武
交谈=攀谈
交替=瓜代
交头接耳=窃窃私议

交往=来往
交心=谈心
交易=生意业务
交友=结交
交战=征战
交织=交错
郊外=郊野
郊野=田野
郊游=远足
娇媚=妩媚
浇灌=灌溉
骄傲=自满
骄兵必败=傲卒多败
骄贵=骄矜
骄气=高慢
骄阳=烈日
骄纵=骄恣
焦点=核心
焦急=焦虑
焦虑=焦急
焦躁=烦躁
角色=脚色
角逐=比赛
侥幸=荣幸
狡辩=诡辩
狡猾=调皮
狡诈=狡猾
皎洁=洁白
矫健=强健
矫揉造作=装腔作势
矫正=改正
脚踏两船=投机取巧
脚踏实地=实事求是
脚印=脚迹
剿灭=剿除
缴获=缉获
叫喊=叫唤
叫好=喝采
叫花子=托钵人
叫嚷=叫喊
叫声=啼声
叫嚣=哗闹
叫醒=唤醒
较劲=较量
较量=比力
教材=课本
教导=辅导
教化=教养
教诲=教导
教练=锻练
教师=西席
教室=课堂
教授=传授
教唆=挑拨
教学=讲授
教训=教导
教养=修养
教育=教诲
阶层=阶级
阶级=阶层
阶梯=门路
阶下囚=囚徒
接班=交班
接班人=接棒人
接触=打仗
接待=欢迎
接二连三=连续不断
接管=接受
接见=访问
接近=靠近
接纳=采取
接收=吸收
接手=接办
接受=担当
接头=讨论
接应=策应
揭穿=戳穿
揭发=检举
揭竿而起=逼上梁山
揭露=揭破
揭示=展现
揭晓=发表
街市=市井
街头=陌头
孑然一身=形单影只
节减=节省
节流=节省
节拍=节奏
节省=节流
节外生枝=添枝加叶
节约=节省
节制=控制
劫持=挟制
劫后余生=大难不死
劫难=灾难
劫数=劫运
杰出=良好
杰作=佳构
诘问=诘责
诘责=诘问
拮据=窘迫
洁白=雪白
洁净=清洁
洁身自爱=守身如玉
结案=了案
结拜兄弟=拜把兄弟
结构=布局
结果=效果
结合=联合
结婚=完婚
结交=交友
结局=了局
结盟=缔盟
结纳=笼络
结亲=攀亲
结实=坚固
结束=竣事
结尾=末端
结业=毕业
结怨=树怨
桀骛=蛮横
捷报=喜报
捷足先登=及锋而试
截然不同=大相径庭
截止=停止
截至=停止
竭尽全力=不遗余力
竭尽心思=殚精竭虑
竭力=勉力
解愁=浇愁
解除=排除
解雇=开除
解救=补救
解决=办理
解剖=剖解
解散=遣散
解释=表明
解说=讲授
解体=崩溃
解脱=摆脱
解危=抒难
解围=得救
解析=剖析
介怀=介意
介入=参与
介绍=先容
介意=介怀
戒备=警备
界线=界限
界限=边界

借道=借路
借故=托故
借鉴=鉴戒
借据=欠据
借口=捏词
借款=乞贷
借钱=乞贷
借题发挥=拐弯抹角
借条=借单
巾帼须眉=女中豪杰
巾帼英雄=女中丈夫
今朝=目前
今非昔比=今是昨非
今后=以后
今年=本年
今日=本日
今生=此生
今世=当代
今天=本日
今夜=彻夜
斤斤计较=琐屑较量
金钱=款项
金衣玉食=锦衣玉食
金玉满堂=富可敌国
津贴=补助
矜持=自持
紧急=告急
紧记=牢记
紧紧=牢牢
紧密=精密
紧迫=紧急
紧要=紧急
紧张=告急
谨记=服膺
谨慎=审慎
锦囊妙计=袖中神算
锦绣=美丽
锦衣玉食=金衣玉食
尽管=只管
尽力=努力
尽量=只管
尽情=恣意
尽善尽美=精美绝伦
尽收眼底=一览无余
尽头=止境
尽心=经心
尽心尽力=全力以赴
尽兴=纵情
尽忠=效忠
劲敌=强敌
劲头=干劲
近况=现状
近来=迩来
近年=比年
近亲=嫡亲
近日=克日
进步神速=一日千里
进场=出场
进程=历程
进出=收支
进攻=打击
进贡=纳贡
进级=升级
进口=入口
进口货=舶来品
进退两难=进退维谷
进退维谷=骑虎难下
进行=举行
进修=学习
进展=希望
晋升=提升
浸染=感化
禁不住=不由得
禁锢=监禁
禁止=克制
噤若寒蝉=默不作声
京城=都城
经办=包办
经常=常常
经过=颠末
经久=耐久
经理=司理
经历=履历
经商=做生意
经受=担当
经验=履历
经营=谋划
经由=经过
荆棘=波折
惊动=轰动
惊愕=恐慌
惊弓之鸟=草木惊心
惊骇=恐惧
惊慌=惶恐
惊慌失措=手忙脚乱
惊惶=错愕
惊恐=恐慌
惊怕=怕惧
惊奇=惊讶
惊叹=赞叹
惊天动地=震天动地
惊心动魄=触目惊心
惊讶=惊奇
旌旗=旗帜
兢兢业业=谨小慎微
精辟=精炼
精采=杰出
精彩=出色
精粹=精炼
精打细算=一个钱打二十四个结
精干=精悍
精悍=干练
精华=英华
精力=精神
精力充沛=精神抖擞
精练=简练
精炼=精粹
精良=良好
精美=精致
精美绝伦=尽善尽美
精密=细密
精明=夺目
精品=佳构
精巧=精良
精确=准确
精深=博识
精神=精力
精神病=神经病
精神抖擞=容光焕发
精神焕发=神采飞扬
精神奕奕=神采奕奕
精髓=精华
精通=醒目
精细=精致
精心=经心
精益求精=字斟句酌
精湛=精深
精致=风雅
精壮=精干
井井有条=井然有序
井然有序=井井有条
景况=境况
景色=景致
景物=风景
景象=情形
景仰=敬慕
警察=警员
警告=告诫
警惕=鉴戒
警卫=保镳
警醒=警觉
竞赛=比赛
敬服=敬重
境地=田地
境界=地步
静静=悄悄
静谧=安谧
静心=埋头
迥然不同=判然不同
窘境=逆境
纠缠=胶葛
纠正=改正
究竟=毕竟
九牛一毫=沧海一粟
九泉=地府
久远=长远
酒杯=羽觞
酒菜=酒席
酒店=旅店
酒绿灯红=花天酒地
酒肉朋友=猪朋狗友
酒席=酒菜
旧病=宿病
旧日=昔日
旧事=往事
旧友=旧交
旧债=宿债
旧帐=宿帐
救兵=援军
救火员=消防员
救急=济急
救济=接济
救生衣=浮水衣
救援=救济
救助=救济
就地=当场
就手=利市
就绪=停当
就义=断送
舅父=母舅
舅舅=娘舅
居安思危=安不忘危
居高临下=高高在上
居民=住民
居所=寓所
居心=故意
居心叵测=居心不良
狙击=偷袭
鞠躬尽瘁=全心全意
局势=局面
局限=范围
咀嚼=品味
举案齐眉=相敬如宾
举办=举行
举措=办法
举动=活动
举高=抬高
举荐=保举
举目无亲=孤苦伶仃
举世=环球
举世无双=独一无二
举一反三=闻一知十
举止高雅=落落大方
具体=详细
剧本=脚本
惧怕=恐惧
据说=听说
距离=间隔
聚餐=会餐
聚会=集会
聚积=堆积
聚精会神=全神贯注
聚敛=剥削
聚散=离合
捐款=捐钱
捐募=捐献
捐钱=捐款
捐躯=断送
捐献=募捐
倦怠=疲倦
眷念=怀念
孓然一身=形影相吊
决策=决议
决绝=断交
决心=刻意
决一死战=背注一掷
决议=决定
决战=决斗
抉择=决议
绝笔=遗言
绝不屈服=百折不挠
绝代=旷世
绝技=特技
觉得=以为
军队=部队
军服=礼服
军功=战功
军火=军器
军舰=兵舰
军人=武士
军师=智囊
军事机密=戎机
军营=虎帐
军装=戎衣
均衡=平衡
均摊=均派
均匀=匀称
俊杰=豪杰
俊丽=美丽
俊逸=飘逸
开办=创办
开辟=开发
开导=启发
开发=开辟
开花=着花
开荒=拓荒
开拓=开辟
开玩笑=开顽笑
楷模=榜样
刊登=登载
勘测=勘察
勘察=勘探
坎坷=崎岖
看成=当作
看穿=看破
看待=对待
看法=见解
看风使舵=见机行事
看管=看守
看护=关照
看见=瞥见
看破=看透
看守=看管
看透=看破
看望=探望
康复=病愈
考查=考察
考察=观察
考场=科场
考核=稽核
考究=讲求
考虑=思量
考试=测验
考验=磨练
考证=考据
犒赏=赏赐
靠得住=可靠
靠山=背景
苛吏=酷吏
瞌睡=打盹
磕头=叩首
可大可小=小大由之
可否=能否
可贵=难得
可口=适口
可能=大概
可怕=可骇
可是=但是
可惜=惋惜
可有可无=无关紧要
克服=降服
克扣=剥削
刻骨铭心=铭肌镂骨
刻画=描画
刻苦=受苦
客官=客长
客套=客气
客厅=客堂
客栈=堆栈
恪守=服从
课本=讲义
课堂=讲堂
溘然=忽然
溘然长逝=撒手尘寰
空白=空缺
空城计=奇策
空地=空隙
空匮=空乏
空气=氛围
空手=白手
空隙=清闲
空中楼阁=蜃楼海市
恐怖=可怕
恐惧=恐惊
恐吓=吓唬
控告=控诉
控诉=控告
口不择言=天花乱坠
口才=谈锋
口齿伶俐=牙白口清
口供=供词
口号=标语
口气=口吻
口味=口胃
口吻=口气
叩首=叩头
叩头=叩首
叩谢=道谢
扣留=监禁
枯木逢春=否极泰来
哭笑不得=啼笑皆非
窟窿=洞穴
苦楚=凄凉
苦力=夫役
苦命=薄命
苦衷=心事
酷吏=苛吏
夸大其词=过甚其辞
夸张=浮夸
垮台=完蛋
跨越=超过
快人快事=干脆爽快
快要=将近
脍炙人口=到处颂扬
宽广=宽阔
宽宏大量=豁略大度
宽阔=宽广
宽慰=抚慰
宽限=脱期
宽心=宽解
款式=格局
款项=款子
狂暴=狞恶
狂潮=怒潮
狂言=大言
狂饮=痛饮
况且=何况
旷地=空地
旷课=缺课
旷世=绝代
旷野=田野
亏得=幸亏
窥探=窥伺
溃烂=腐败
溃散=崩溃
溃逃=崩溃
馈赠=奉送
困顿=困窘
困惑=狐疑
困境=逆境
困窘=困顿
困倦=困乏
来回=往返
来历=来源
来临=到临
来去=往复
来源=泉源
栏杆=雕栏
烂漫=绚丽
烂醉如泥=玉山颓倒
狼狈不堪=狼狈万状
狼狈而逃=抱头鼠窜
狼狈为奸=朋比为奸
狼藉=散乱
浪潮=海潮
浪子=荡子
劳顿=劳累
劳驾=屈驾
劳神=费神
牢靠=牢固
牢骚=怨言
牢狱=监狱
唠叨=絮聒
唠唠叨叨=刺刺不休
老到=老练
老规矩=老例子
老汉=老夫
老家=故乡
老将=宿将
老婆=妻子
老少=老小
老实=诚实
老是=总是
老太婆=老妇人
老态龙钟=齿豁头童
老小=老少
老羞成怒=大发雷霆
乐谱=曲谱
乐趣=兴趣
乐融融=乐陶陶
乐土=乐园
乐园=乐土
勒令=迫令
勒索=打单
雷霆万钧=排山倒海
雷同=类似
泪流满面=泪如泉涌
泪如泉涌=泪流满面
泪如雨下=泪流满面
泪眼汪汪=泪流满面
类别=种别
类似=雷同
类型=范例
冷淡=淡漠
冷风=凉风
冷光=寒光
冷汗=盗汗
冷箭=暗箭
冷静=岑寂
冷酷=冷漠
冷落=荒凉
冷漠=淡漠
冷暖自知=心里有数
冷僻=冷清
冷气=寒气
冷清=冷静
冷笑=嘲笑
冷战=暗斗
愣住=停住
离别=告别
离合=聚散
离婚=仳离
离间=诽谤
离开=脱离
离奇=古怪
离去=拜别
离职=去职
黎民=百姓
罹难=遭灾
礼拜=星期
礼服=制服
礼节=礼仪
礼貌=规矩
礼品=礼物
礼聘=聘请
礼让=谦逊
礼尚往来=投桃报李
礼堂=会堂
礼物=礼品
礼仪=礼节
里面=内里
理睬=答理
理当如此=天经地义
理发=剃头
理会=剖析
理解=明白
理屈词穷=默不作声
理所当然=天经地义
理想=抱负
理由=来由
理直气壮=义正辞严
力不从心=力有未逮
力大无穷=孔武有力
力量=气力
力求=力图
力争=力图
历程=进程
历尽沧桑=饱经风霜
历尽艰辛=含辛茹苦
历久=长期
历来=向来
历历在目=念念不忘
历年=积年
历史=汗青
厉兵秣马=盛食厉兵
厉害=锋利
立案=备案
立场=态度
立杆见影=吹糠见米
立功=建功
立即=立刻
立刻=立即
立名=扬名
立身=立品
立誓=发誓
立志=发愤
立足=驻足
利便=方便
利害=好坏
利息=利钱
利益=长处
利用=使用
利欲熏心=自私自利
例如=比方
例外=破例
例行公事=官样文章
隶属=从属
莅临=到临
连合=团结
连接=毗连
连累=牵连
连络=连系
连忙=立刻
连绵=绵延
连年=比年
连任=蝉联
连系=结合
连续=一连
连续不断=接二连三
怜爱=垂怜
怜悯=恻隐
怜惜=痛惜
涟漪=荡漾
联贯=连绵
联合=团结
联婚=联姻
联络=联结
联袂=携手
联盟=同盟
联系=接洽
联想=遐想
联姻=攀亲
廉价=便宜
廉洁=耿介
脸蛋=面庞
脸红=酡颜
脸颊=面颊
脸孔=面目
脸色=表情
练习=训练
恋爱=爱情
恋人=情人
良好=精良
良久=很久
良心=本心
良药苦口=忠言逆耳
良知=知己
凉风=冷风
凉爽=凉快
两边=双方
两端=两头
两极=南北极
两全其美=一箭双m
两头=两端
两小无猜=青梅竹马
两袖清风=囊空如洗
亮相=表态
谅解=体谅
量力而行=实事求是
辽阔=广阔
聊天=谈天
寥寂=寂寥
寥寥无几=寥若晨星
寥若晨星=寥寥无几
嘹亮=洪亮
了不起=了不得
了结=告终
了解=相识
了却=了结
了如指掌=洞若观火
料到=推测
料理=摒挡
料事如神=臆则屡中
料想=意料
列举=枚举
劣货=次货
劣行=败行
烈火=猛火
烈日=骄阳
烈士=义士
裂缝=缝隙
裂痕=裂缝
邻接=毗邻
邻近=相近
邻居=邻人
林林总总=各式各样
临机应变=临机处置
临近=邻近
临摹=摹仿
临时=暂时
临危不惧=见义勇为
淋漓尽致=极尽描摹
吝惜=怜惜
伶仃=孤独
伶俐=聪明
灵魂=魂魄
灵活=机动
灵敏=敏捷
灵巧=机灵
灵药=仙丹
凌晨=破晓
凌驾=高出
凌乱=缭乱
凌虐=虐待
凌云壮志=志薄云霄
聆听=凝听
零乱=庞杂
零落=寥落
零散=零星
零碎=琐屑
零星=零散
领导=向导
领会=了解
领略=明白
领情=承情
领土=国土
领悟=意会
领袖=首脑
领域=范畴
令郎=公子
令人发指=怒不可遏
另具匠心=别开生面
另起炉灶=重新努力别辟门户
另外=别的
另眼相看=刮目相看
另有=尚有
溜冰=滑冰
溜之大吉=抱头鼠窜
浏览=欣赏
流畅=流通
流传=传播
流动=活动
流芳百世=千古流芳
流放=放逐
流浪=流离
流泪=堕泪
流离=流浪
流离失所=颠沛流离
流连忘返=乐不思蜀
流露=表露
流落=漂泊
流氓=地痞
流通=流畅
流亡=避难
流行=盛行
流言=浮名
流言蜚语=飞短流长
留步=停步
留恋=迷恋
留情=包涵
留神=留意
留宿=过夜
留心=把稳
留意=注意
六根清净=一乾二净
六神无主=魂飞魄散
龙飞凤舞=鸾翔凤翥
龙精虎猛=生龙活虎
龙马精神=龙腾虎跃
龙蛇混杂=泥沙俱下
龙腾虎跃=龙马精神
笼络=拉拢
笼罩=包围
隆重=谨慎
垄断=把持
陋俗=鄙俗
陋习=成规
漏电=泄电
漏掉=遗漏
漏洞=毛病
漏网之鱼=丧家之犬
露出=暴露
露马脚=出漏洞
露水=露珠
露珠=露水
炉火纯青=出神入化
卤莽=粗鲁
陆续=连续
录取=登科
录音=灌音
录用=任命
碌碌无为=凑数其间
路程=旅程
路费=盘费
路过=途经
路线=门路
旅程=路程
旅店=旅馆
旅馆=旅店
旅客=游客
旅行=观光
屡次=频频
屡见不鲜=家常便饭
屡屡=频频
履行=推行
律例=法规
律师=状师
率领=带领
率直=坦白
乱闯=乱撞
乱来=瞎搅
乱骂=漫骂
乱七八糟=七零八落
乱世=浊世
乱说=胡说
乱撞=乱闯
掠夺=打劫
掠过=擦过
沦落=沉溺
沦亡=沦陷
沦陷=陷落
轮船=汽船
轮番=轮替
轮回=循环
轮廓=表面
轮流=轮番
轮替=轮番
论功行赏=照功行赏
论述=叙述
罗列=摆列
络绎不绝=继续不停
落成=完工
落后=落伍
落花流水=屁滚尿流
落井下石=雪上加霜
落落大方=举止高雅
落难=流浪
落魄=崎岖潦倒
落日=夕阳
落网=就逮
落伍=掉队
落选=落第
麻烦=贫苦
麻木=麻痹
麻醉剂=镇痛剂
马不停蹄=快马加鞭
马到成功=旗开马到
马脚=破绽
马马虎虎=敷衍了事
马上=立刻
马首是瞻=密切追随
码头=船埠
埋伏=匿伏
埋没=隐藏
埋头=笃志
埋怨=抱怨
埋葬=安葬
买办=大班
买卖=交易
卖力=认真
卖弄=矫饰
蛮横=霸道
蛮横无理=强词夺理
蛮人=生番
蛮夷=夷狄
满身=浑身
满意=满足
满足=满意
谩骂=诅咒
慢慢=逐步
漫笔=随笔
漫不经心=不以为意
漫步=闲步
漫无止境=得陇望蜀
漫游=周游
蔓延=伸张
忙碌=繁忙
盲人=瞽者
盲眼=瞎眼
莽撞=冒失
毛病=弊端
毛骨悚然=不寒而栗
毛遂自荐=自我介绍
矛盾=抵牾
茅厕=厕所
茅屋=茅舍
茂盛=繁茂
冒充=假冒
冒犯=得罪
冒昧=造次
冒名行骗=招摇撞骗
冒失=鲁莽
冒死=搏命
贸易=商业
貌合神离=同床异梦
没关系=不要紧
没精打采=垂头丧气
没落=消灭
没没无闻=籍籍无名
没趣=败兴
没收=充公
没头没脑=劈头盖脸
枚举=罗列
眉飞色舞=欢天喜地
眉开眼笑=眉飞色舞
眉目=端倪
眉目传情=眼去眉来
媒介=前言
媒婆=牙婆
媒人=媒妁
煤油=火油
每每=通常
每日=逐日
每时每刻=时时刻刻
每天=天天
美丑=妍媸
美观=雅观
美好=优美
美酒=琼浆
美丽=漂亮
美轮美奂=竹苞松茂
美满=完满
美满收场=曲终奏雅
美貌=仙颜
美梦=好梦
美妙=美好
美名=隽誉
美男=美女
美女=玉人
美人=尤物
美谈=佳话
美味=鲜味
美意=盛情
门第=家世
门风=家声
门户=流派
门路=蹊径
门生=弟子
门庭若市=华盖云集
门外汉=外行人
扪心=抚心
扪心自问=抚躬自问
闷闷不乐=忽忽不乐
萌芽=抽芽
盟国=友邦
盟主=牛耳
朦胧=昏黄
猛火=烈火
猛将=虎将
猛烈=剧烈
蒙昧=无知
蒙受=遭受
懵懂一时=聪明一世
梦话=梦呓
梦境=梦乡
梦寐以求=求之不得
梦乡=梦境
梦想=空想
弥补=补充
弥留=垂危
迷糊=含糊
迷惑=疑惑
迷恋=留恋
迷茫=渺茫
迷迷糊糊=模模糊糊
迷途=失路
迷途知反=觉返迷津
谜底=答案
靡靡之音=濮上之音
米已成炊=木已成舟
秘籍=秘笈
秘诀=法门
秘密=机密
密集=麋集
密码=暗码
密谋=谋害
密友=好友
密语=私语
蜜语=甜言
绵绵不断=源源不绝
免除=免去
免得=省得
免去=免除
免职=夺职
勉励=鼓励
勉强=委曲
缅怀=惦记
腼腆=忸怩
面对=面临
面颊=脸颊
面孔=面貌
面临=面对
面貌=面目
面面俱到=八面见光
面目=面貌
面目可憎=言语无味
面目全非=面目一新
面目一新=焕然一新
面前=眼前
面容=面目面貌
面如土色=面如死灰
面色苍白=面无人色
面试=口试
面子=体面
描画=描绘
描绘=刻画
描摹=形貌
描述=形貌
描写=形貌
瞄准=对准
眇小=渺小
渺茫=迷茫
渺视=傲睨
渺小=眇小
妙计=奇策
妙龄少女=二八佳人
妙手=能手
妙手回春=药到回春
妙算=神算
妙想天开=胡思乱想
妙药=灵药
妙语=趣话
妙语横生=谈笑风生
庙宇=古刹
灭顶=溺死
灭绝=灭尽
灭亡=死亡
蔑视=鄙视
民风=民俗
民生凋敝=百孔千疮
民俗=民风
民心=民气
民众=大众
泯灭=淹灭
敏捷=灵敏
名存实亡=名不副实
名贵=宝贵
名过其实=过甚其实
名利双收=求名求利
名列前茅=压倒一切
名流=名士
名门=王谢
名目=款式
名片=手刺
名人=名流
名胜=胜景
名堂=花样
名望=名誉
名誉=光荣
名誉扫地=臭名昭着
名震一时=声誉鹊起
名正言顺=光明正大
明白=明确
明辨是非=是非分明
明朗=清朗
明亮=豁亮
明了=明白
明媚=妖冶
明明=明显
明目张胆=明火执仗
明年=来岁
明枪暗箭=明争暗斗
明确=明白
明日=嫡
明日黄花=时过境迁
明示=昭示
明天=来日诰日
明晰=明了
明显=显着
明哲保身=一尘不染
明争暗斗=明枪暗箭
明知故犯=州官放火
鸣金收兵=销声匿迹
铭记=铭刻
命令=下令
命脉=命根子
命名=定名
命途多舛=生不逢辰
命运=运气
命中=掷中
摸索=探索
模范=榜样
模仿=模拟
模糊=含糊
模棱两可=含糊其词
模模糊糊=迷迷糊糊
模拟=模仿
模型=模子
模样=容貌
膜拜=敬拜
摩登=漂亮
磨练=检验
磨炼=锻炼
磨灭=消逝
磨难=苦难
魔法=邪术
魔鬼=妖怪
魔难=苦难
魔术=把戏
抹煞=勾消
末端=末了
末尾=末端
陌生=生疏
莫非=难道
漠不关心=漫不经心
漠然置之=置若罔闻
蓦地=猛然
蓦然=蓦地
墨客=书生
墨守成规=抱残守缺
默不作声=默默无言
默默=冷静
默默无言=默不作声
默然=缄默
谋害=密谋
谋划=策划
谋略=盘算
谋面=碰面
谋求=钻营
谋杀=行刺
谋生=营生
谋事=找事
谋事在人=人定胜天
某人=或人
母老虎=母大虫
木材=木料
木柴=木料
木工=木匠
木鸡之呆=目瞪口呆
木匠=木工
木料=木柴
木已成舟=米已成炊
目标=目的
目不识丁=胸无点墨
目不斜视=聚精会神
目不转睛=目不斜视
目的=目标
目瞪口呆=理屈词穷
目睹=眼见
目光=眼光
目光短浅=目光如豆
目光如炬=目光如电
目击=眼见
目空一切=目中无人
目录=目次
目前=现在
目染耳濡=见闻习染
目无王法=目无法纪
目眩=眼花
目中无人=目空一切
沐浴=洗浴
募集=召募
墓地=坟场
暮年=老年
暮气=死气
暮气沉沉=灰心丧气
拿定主意=打定主意
拿手=特长
哪里=那里
内地=本地
内涵=内在
内哄=内乱
内讧=内耗
内疚=忸怩
内陆=本地
内乱=内乱
内幕=黑幕
内情=底细
内外=表里
内心=心田
内行=老手
内衣=亵服
内在=内涵
那边=那里
那个=谁人
那里=那边
那时=当时
纳贿=受贿
纳凉=乘凉
纳闷=烦闷
乃至=以致
奶名=小名
奈何=怎样
耐烦=耐心
耐久=历久
耐劳=刻苦
耐心=耐烦
耐性=耐烦
男儿膝下有黄金=男子汉大丈夫
男人=男子
男子=夫君
男子汉大丈夫=男儿膝下有黄金
南边=南方
南方=南边
南柯一梦=黄粱一梦
南辕北辙=背道而驰
南征北战=出生入死
难熬=难过
难道=岂非
难得=难过
难懂=难明
难过=惆怅
难解=难明
难堪=难过
难看=丢脸
难免=不免
难民=灾黎
难民营=栖流所
难明=难懂
难舍难分=藕断丝连
难受=难熬
难题=困难
难听=刺耳
难兄难弟=一丘之貉
难以估计=无法计算
难以想象=不可思议
囊括=席卷
囊中物=瓮中鳖
恼恨=愤恨
恼羞成怒=大发雷霆
脑袋=脑壳
脑筋=头脑
脑壳=脑袋
脑子=脑筋
闹饥荒=打饥荒
闹事=生事
呐喊=叫嚣
能否=可否
能干=醒目
能够=可以或许
能力=本领
能言善辩=舌粲莲花
泥土=土壤
你死我活=不共戴天
拟订=订定
拟定=制定
逆耳=刺耳
逆境=窘境
逆来顺受=唾面自干
溺爱=宠爱
溺死=灭顶
拈花惹草=寻花问柳
年华=光阴
年纪=年龄
年老=大哥
年龄=年事
年迈=年老
年青=年轻
年轻力壮=手轻脚健
年轻貌美=绮年玉貌
年少=幼年
年事=年岁
年数=年纪
年岁=年龄
年头=年初
年尾=年末
年幼无知=少不更事
年月=年代
年终=年末
念佛=念经
念经=念佛
念念不忘=念兹在兹
念书=读书
念头=动机
娘家=外家
娘舅=母舅
酿成=变成
鸟尽弓藏=兔死狗烹
鸟语花香=莺啼燕语
捏造=假造
宁静=平静
宁可=宁肯
宁肯=宁愿
宁死不屈=宁当玉碎
宁为玉碎=不屈不挠
宁愿=甘心
狞笑=奸笑
凝结=凝聚
凝聚=凝结
凝神=凝思
凝视=注视
凝望=凝视
凝滞=呆滞
牛头不对马嘴=驴唇不对马嘴
忸怩=内疚
农夫=农民
农历=夏历
农民=农夫
浓厚=浓重
浓烈=浓郁
浓密=稠密
浓郁=浓厚
浓重=浓厚
浓妆=盛饰
浓妆艳抹=浓装艳裹
脓包=饭桶
奴婢=仆众
奴才=仆从
奴隶=仆从
奴仆=奴婢
奴颜婢膝=卑躬屈膝
努力=积极
怒发冲冠=拊膺切齿
怒吼=咆哮
怒火=肝火
怒火万丈=拊膺切齿
怒火中烧=拊膺切齿
怒气=肝火
怒气冲冲=怒气冲发
怒气冲天=拊膺切齿
怒视=瞪眼
女婢=女侍
女强人=铁娘子
女士=密斯
女婿=半子
女优=女伶
女中豪杰=女中丈夫
女中丈夫=女中豪杰
虐待=荼毒
虐政=暴政
暖和=温暖
挪用=调用
诺言=信誉
懦夫=怯夫
懦弱=脆弱
讴歌=歌唱
欧美=西欧
呕吐=吐逆
呕心沥血=费尽心血
偶尔=偶然
偶然=偶尔
藕断丝连=难舍难分
趴下=爬下
爬山=登山
爬下=趴下
怕羞=害臊
拍案叫绝=击节称赏
拍马屁=捧臭脚
拍门=打门
拍手=鼓掌
拍照=照相
徘徊=倘佯
排场=场面
排斥=排挤
排出=排挤
排除=清除
排队=列队
排挤=倾轧
排练=排演
排列=分列
排遣=排解
排山倒海=翻江倒海
排泄=分泌
排演=排练
牌坊=牌楼
牌楼=牌坊
派别=流派
派遣=调派
派头=气魄
攀登=攀缘
攀附=攀援
攀亲=联姻
攀谈=交谈
盘查=盘问
盘缠=旅费
盘点=盘货
盘蹲=箕踞
盘据=分裂
盘问=查问
盘旋=回旋
判别=鉴别
判定=判断
判断=判定
判决=讯断
叛变=变节
叛乱=兵变
叛逆=反叛
盼望=渴望
盼愿=盼望
滂湃=滂沱
滂沱=滂湃
滂沱大雨=倾盆大雨
庞大=巨大
庞杂=繁芜
旁观=观看
旁门=歪路
旁敲侧击=拐弯抹角
旁若无人=不可一世
旁征博引=引经据典
抛弃=扬弃
抛掷=投掷
炮竹=爆仗
跑江湖=跑码头
跑马=赛马
泡茶=沏茶
陪伴=伴随
陪衬=衬托
陪同=陪伴
陪罪=告罪
培养=造就
培育=培养
培植=扶植
赔本=亏本
赔偿=补偿
赔礼=赔罪
赔罪=谢罪
佩带=佩戴
佩戴=佩带
佩服=敬佩
配合=共同
配角=副角
配偶=夫妇
配药师=药剂师
配置=设置
抨击=反攻
烹饪=烹调
朋比为奸=通同作恶
朋友=朋侪
蓬勃=发达
澎湃=汹涌
捧场=恭维
碰杯=举杯
碰壁=碰钉子
碰到=遇到
碰钉子=碰鼻
碰见=遇见
碰面=谋面
碰巧=可巧
碰头=见面
碰着=碰到
批驳=驳倒
批改=修正
批判=批驳
批评=品评
批示=指挥
批注=讲明
批准=答应
纰漏=马虎
纰谬=不对
披发=散发
披肝沥胆=丹成相许
披荆斩棘=披荆棘
披麻带孝=拖麻拽布
披头散发=蓬首垢面
披星戴月=栉风沐雨
披阅=披览
劈头=开端
劈腿=劈叉
霹雳=轰隆
毗邻=连接
疲惫=疲劳
疲倦=倦怠
疲劳=疲惫
脾气=性情
脾性=脾气
匹敌=对抗
匹夫之勇=血气之勇
僻静=平静
譬喻=比方
片段=片断
片刻=半晌
片面=单方面
片面之词=片面之言
片晌=片刻
偏爱=偏幸
偏差=毛病
偏护=包庇
偏激=过火
偏见=私见
偏僻=冷僻
偏袒=左袒
偏向=方向
偏心=偏爱
偏言=曲说
偏重=侧重
骗财=诈财
骗人=哄人
剽悍=G悍
剽窃=抄袭
漂泊=流落
漂荡=飘零
漂浮=漂泊
漂亮=美丽
漂流=漂泊
飘荡=飘扬
飘零=飘荡
飘飘然=由由然
飘扬=飘荡
飘逸=俊逸
票据=单子
嫖妓=冶游
瞥见=望见
拼凑=拼集
拼命=冒死
拼死=搏命
贫乏=缺少
贫寒=清贫
贫苦=贫困
贫困=贫苦
贫民=穷人
贫穷=贫苦
贫血=血虚
频繁=频仍
频频=反复
品德=品行
品格=风致
品味=咀嚼
品行=操行
品质=品格
聘请=约请
聘用=聘任
平安=安全
平安无事=安然无恙
平步青云=青云直上
平常=寻常
平旦=平明
平淡=平庸
平等=同等
平定=安定
平凡=平常
平反=昭雪
平分=中分
平分秋色=半斤八两
平衡=均衡
平静=清静
平局=平手
平均=均匀
平民=布衣
平起平坐=不相上下
平日=通常
平生=一生
平时=平常
平坦=平展
平坦大路=康庄大道
平稳=安稳
平心而谈=持平立论
平心静气=心平气和
平易=夷易
平易近人=和颜悦色
评比=评选
评论=批评
评判员=裁判员
评述=批评
评头论足=说长道短
评选=评比
评语=考语
凭借=依附
凭据=根据
凭空捏造=闭门造车
凭证=凭据
屏弃=摈弃
屏障=屏蔽
萍水相逢=不期而遇
泼妇=恶妻
泼辣=凶暴
泼皮=地痞
迫不得已=必不得已
迫不及待=如饥似渴
迫害=毒害
迫近=逼近
迫良为娼=逼良为娼
迫切=急迫
迫在眉睫=迫不及待
破产=停业
破除=排除
破费=花费
破釜沉舟=背城借一
破坏=粉碎
破镜重圆=坠欢重拾
破口大骂=扬声恶骂
破例=例外
破裂=破碎
破灭=幻灭
破碎=破裂
破损=破坏
破涕为笑=转悲为喜
破绽=漏洞
魄力=气概气派
剖白=辨白
剖辨=别析
剖解=解剖
剖释=剖判
剖析=分析
仆从=跟班
仆人=仆役
仆役=西崽
扑打=鞭挞
扑面=劈面
扑灭=毁灭
扑朔迷离=空中楼阁
铺开=放开
铺排=摆设
铺张=浪费
朴陋=空洞
朴实=朴素
朴素=质朴
普遍=广泛
普及=遍及
普天同庆=率土同庆
普通=平凡
七上八下=忐忑不安
七手八脚=手足无措
七嘴八舌=人多口杂
沏茶=泡茶
妻子=老婆
凄惨=凄切
凄凉=悲凉
栖身=居住
期待=等待
期望=盼望
期限=限期
欺负=欺凌
欺凌=陵暴
欺骗=诱骗
欺善怕恶=欺软怕硬
欺侮=侮辱
欺压=欺凌
欺诈=敲诈
漆黑=黑暗
齐集=会合
齐全=齐备
齐心=同心
齐整=划一
其后=厥后
其时=当时
其实=实在
其它=别的
其余=别的
其中=此中
奇奥=奇妙
奇怪=希奇
奇观=异景
奇迹=古迹
奇丽=秀丽
奇妙=奥妙
奇人=怪杰
奇特=奇异
奇异=奇特
歧视=鄙视
歧途=邪路
祈祷=祷告
祈望=盼望
崎岖=坎坷
骑虎难下=进退维谷
棋逢敌手=将遇良才
旗鼓相当=半斤八两
旗号=旗帜
旗开得胜=马到成功
旗手=旗头
旗帜=旌旗
旗子=旌旗
乞丐=托钵人
乞求=恳求
企盼=瞻仰
企图=计划
企望=盼望
启程=起程
启齿=开口
启迪=启示
启发=开导
启航=动身
启蒙=发蒙
杞人忧天=庸人自扰
起草=草拟
起程=动身
起初=早先
起点=出发点
起飞=腾飞
起伏=升沉
起家=发迹
起劲=努力
起落=升降
起码=最少
起色=转机
起身=起家
起死回生=死去活来
起诉=告状
起义=叛逆
起因=因由
起源=劈头
绮丽=富丽
绮绮子弟=绮襦纨裤
气昂昂=雄赳赳
气度=心胸
气氛=氛围
气忿=愤怒
气愤=生气
气概=风格
气候=天气
气力=力气
气量=宇量
气馁=灰心
气派=派头
气魄=气势
气势=气魄
气势磅R=气吞山河
气势ZZ=威风凛凛
气息=气味
气象=景象
气焰=气势
气宇轩昂=高视睨步
泣如雨下=泪流满面
契约=左券
器材=东西
器具=用具
器量=度量
器械=东西
恰当=适当
恰到好处=恰如其分
恰好=恰恰
恰恰=恰好
恰巧=碰巧
恰如其分=恰到好处
恰似=好似
洽商=洽谈
洽谈=洽商
千般=百般
千变万化=变化多端
千锤百炼=精益求精
千方百计=费尽心机
千古流芳=流芳百世
千金=令媛
千钧一发=岌岌可危
千篇一律=如出一辙
千奇百怪=光怪陆离
千头万绪=盘根错节
千万=万万
千辛万苦=历尽艰辛
千载难逢=千载一时
千真万确=确切不移
迁就=将就
迁居=搬家
迁徙=迁移
迁移=迁徙
牵扯=牵涉
牵挂=挂念
牵连=连累
牵涉=扳连
牵制=管束
谦和=谦恭
谦让=忍让
谦虚=谦善
谦逊=谦虚
签订=签署
签定=签订
签名=署名
签署=签订
签字=具名
前辈=先辈
前车之鉴=前车可鉴
前程=出息
前方=火线
前锋=先锋
前功尽弃=半途而废
前呼后拥=一呼百诺
前进=进步
前景=远景
前列=前线
前仆后继=前赴后继
前去=前往
前生=宿世
前世=宿世
前思后想=忖前思后
前所未有=亘古未有
前提=条件
前途=前程
前往=前去
前线=火线
前言=媒介
前因后果=来龙去脉
前兆=先兆
钤记=图章
虔诚=虔敬
钱币=货币
钱财=财帛
钱庄=银号
潜伏=埋伏
潜匿=埋没
潜逃=叛逃
潜在=潜伏
黔驴技穷=黔驴之技
浅薄=浮浅
浅见=肤见
浅陋=浅薄
浅色=淡色
浅显=浅近
浅笑=含笑
浅易=浅显
遣散=驱逐
谴责=非难
欠好=不好
欠据=借据
欠缺=短缺
欠妥=不当
欠债=负债
强暴=强横
强逼=逼迫
强词夺理=蛮横无理
强大=强盛
强盗=匪贼
强敌=劲敌
强调=夸大
强悍=刁悍
强横=霸道
强健=矫健
强烈=猛烈
强迫=逼迫
强人=能人
强盛=强大
强项=刚强
强硬=倔强
强制=逼迫
强壮=强健
抢夺=劫掠
抢劫=掳掠
抢救=救济
抢掠=劫掠
抢先=争先
悄悄=静静
悄悄的=偷偷的
悄然=寂静
敲门=拍门
敲诈=诓骗
乔迁=燕徙
乔迁之喜=出谷迁乔
乔妆=改扮
憔悴=干瘪
巧夺天工=鬼斧神工
巧合=偶合
巧妙=奇妙
巧取豪夺=敲诈勒索
巧言=巧舌
窍门=秘诀
切磋=探讨
切断=堵截
切肤之痛=切身痛苦
切记=牢记
怯弱=胆小
窃看=偷窥
窃窃私语=交头接耳
窃取=盗取
窃笑=暗笑
惬意=舒服
锲而不舍=坚持不懈
亲爱=酷爱
亲近=密切
亲密=密切
亲昵=密切
亲切=密切
亲热=亲切
亲如手足=情同骨肉
亲身=切身
亲信=知己
亲友=亲朋
亲属=支属
亲自=亲身
侵夺=劫夺
侵犯=侵占
侵害=陵犯
侵略=侵犯
侵扰=扰乱
侵蚀=腐蚀
侵吞=陵犯
侵占=陵犯
钦佩=佩服
秦晋之好=两姓之欢
勤奋=勤劳
勤恳=勤奋
勤苦=发愤
勤劳=勤奋
勤学=好学
寝食不安=食不甘味
寝室=睡房
青出于蓝=后来居上
青春=芳华
青翠=青葱
青红皂白=是非黑白
青梅竹马=两小无猜
青天=彼苍
青蛙=田鸡
青云直上=扶摇直上
轻便=轻巧
轻薄=浮滑
轻车熟路=得心应手
轻渎=侮慢
轻而易举=十拿九稳
轻风=微风
轻浮=浮滑
轻举妄动=胆大妄为
轻狂=浮滑
轻率=草率
轻慢=骄易
轻蔑=轻视
轻敲=小扣
轻巧=轻便
轻巧=轻盈
轻视=轻蔑
轻手轻脚=蹑手蹑脚
轻微=稍微
轻易=容易
倾覆=颠覆
倾家荡产=败尽家业
倾慕=倾心
倾盆=滂湃
倾盆大雨=滂沱大雨
倾诉=倾吐
倾听=谛听
倾吐=倾诉
倾泻=倾注
倾心=倾慕
清白=明净
清澈=清亮
清晨=清早
清除=扫除
清楚=清晰
清脆=响亮
清淡=平淡
清点=盘点
清高=狷介
清规戒律=金科玉律
清剿=剿灭
清洁=干净
清静=寂静
清冷=清凉
清理=清算
清廉=廉洁
清凉=清冷
清亮=清澈
清明=明朗
清贫=贫苦
清扫=排除
清爽=清新
清水=净水
清算=整理
清晰=清楚
清洗=洗濯
清闲=安定
清醒=苏醒
清秀=秀气
清幽=幽静
清早=朝晨
情报=谍报
情不自禁=不由自主
情感=情绪
情景=景象
情况=环境
情面=人情
情人=恋人
情同骨肉=情同手足
情同手足=情同骨肉
情投意合=同舟共济
情形=情况
情绪=感情
情义=情谊
情谊=友谊
情意=情谊
情有独锺=情之所锺
情有可原=无可非议
情愿=甘心
情之所锺=有独锺
晴朗=明朗
晴天=好天
擎天一柱=砥柱中流
顷刻=霎时
请安=致意
请假=告假
请柬=请帖
请教=讨教
请客=宴客
请求=哀求
请示=叨教
请帖=请柬
请托=拜托
请问=叨教
请愿=示威
庆贺=庆祝
庆幸=光荣
庆祝=庆贺
穷乏=贫乏
穷苦=贫苦
穷困=贫乏
穷困潦倒=潦倒穷困
穷人=贫民
穷途潦倒=命运坎坷
穷途末路=断港绝潢
穷乡僻壤=穷山垩水
穷凶极恶=暴戾恣睢
秋风=金风抽丰
秋高气爽=天高气爽
秋天=秋日
囚犯=犯人
求教=讨教
求情=讨情
求全=责备
求饶=讨饶
求神拜佛=拜鬼求神
求贤若渴=爱才如命
求学=修业
求之不得=梦寐以求
求助=告急
区区=戋戋
区域=地区
曲谱=乐谱
曲直=是曲
驱使=驱策
祛除=消灭
趋之若鹜=趋附者众
取代=代替
取暖=取暖和
取舍=弃取
取笑=讽刺
取悦=媚谄
娶妻=授室
娶妾=纳宠
娶亲=结婚
去处=行止
去年=客岁
去逝=毕命
去向=去处
去职=离职
趣味=意见意义
趣闻=妙闻
圈套=骗局
全国=天下
全家=百口
全军=三军
全军覆没=全军尽没
全靠=端赖
全力=尽力
全能=万能
全年=整年
全盘=通盘
全球=环球
全日=整日
全身=满身
全神贯注=聚精会神
全是=满是
全心=经心
全愈=病愈
权柄=职权
权贵=显贵
权衡=衡量
权力=权利
权略=机谋
权谋=权术
权术=霸术
权威=权势巨子
诠释=解释
痊愈=病愈
劝化=感导
劝戒=规劝
劝说=奉劝
缺课=旷课
缺漏=罅漏
确立=建立
群集=聚集
然则=但是
染病=抱病
染指=问鼎
饶恕=宽恕
惹火烧身=引火烧身
惹祸=肇事
惹恼=触怒
热潮=高潮
热忱=激情亲切
热点=热门
人道=人性
人地相宜=地利人和
人浮于事=僧多粥少
人格=品德
人口=生齿
人老珠黄=老树枯柴
人面兽心=行同狗彘
人命=性命
人品=品德
人情=情面
人情冷暖=世态炎凉
人人=大家
人世=人间
人算不如天算=千算万算，不值天一划
人心=民气
人心惶惶=胆战心惊
人烟=火食
人员=职员
人缘=因缘
忍不住=不由得
认可=承认
认识=熟悉
认为=以为
任凭=听凭
任务=使命
任意=恣意
扔掉=抛弃
仍旧=仍然
仍然=仍旧
仍是=还是
日常=一样平常
日记=日志
日间=白天
日志=日记
戎马=兵马
荣华=繁华
荣耀=光彩
容貌=边幅
容易=轻易
容隐=包庇
熔解=溶化
融会=领悟
柔美=优美
柔嫩=柔软
如此=云云
如故=仍旧
如果=假如
如何=怎样
如何是好=如之奈何
如虎添翼=为虎傅翼
如火如荼=风起云涌
如获至宝=大喜过望
如今=现在
如期=准期
如日中天=方兴未艾
如同=犹如
如意=快意
如影随形=跬步不离
辱骂=唾骂
入神=着迷
润泽=滋润
若干=多少
若何=如何
若是=如果
若有=如有
弱点=缺点
撒播=流传
撒谎=说谎
撒野=撒泼
洒泪=挥泪
洒脱=潇洒
塞翁失马=因祸得福
赛跑=竞走
三更=半夜
三令五申=再三告诫
三五成群=成群结队
三足鼎立=鼎足之势
散伙=拆伙
丧家之犬=漏网之鱼
丧尽天良=丧心病狂
丧心病狂=丧尽天良
扫除=打扫
扫墓=省墓
森林=丛林
杀绝=扑灭
杀戮=杀害
杀青=达成
杀人如麻=滥杀无辜
杀一儆百=杀鸡骇猴
沙场=疆场
沙漠=戈壁
沙滩=沙岸
刹时=瞬间
傻人有傻福=天公疼核
山川=山水
山洞=岩穴
山河=江山
山水=山川
山寨=盗窟
删改=编削
煽动=煽惑
闪开=让开
闪烁=闪耀
闪耀=闪灼
闪灼=闪烁
善恶不分=黑白不分
擅长=善于
擅自=私自
赡养费=米饭钱
伤风=感冒
伤风败俗=有伤风化
伤痕累累=遍体鳞伤
商场=a_
商店=市肆
商量=探讨
商铺=商店
商榷=商讨
商人=贩子
商业=贸易
商议=商量
赏罚=惩罚
赏给=赐给
赏光=赏脸
赏脸=赏光
赏识=欣赏
赏心悦目=心旷神怡
上岸=登陆
上苍=彼苍
上次=前次
上当=被骗
上帝=天主
上吊=吊颈
上钩=中计
上将=大将
稍微=轻微
舍本逐末=本末倒置
设备=装备
设法=想法
设计=计划
设施=办法
设想=假想
设宴=设席
社交=交际
涉水=渡水
赦免=赦宥
摄影=拍照
申辩=辩论
申明=说明
申诉=申说
伸展=舒展
身材=身段
身段=身材
身分=因素
身后=死后
身世=出身
身手=技艺
身体=身材
身形=体态
绅士=名流
深恶痛绝=切齿腐心
深交=厚交
深究=穷究
深情=蜜意
深思熟虑=深图远虑
深信=笃信
深挚=深厚
神采奕奕=神采飞扬
神出鬼没=出没无常
神经病=精神病
神秘=秘密
神气=神情
神情=模样形状
神色=脸色
神算=妙算
神态=模样形状
神往=向往
神志=神态
审查=检察
审核=考核
审视=审阅
审问=过堂
审讯=审判
审阅=审视
甚至=乃至
渗出=排泄
渗透=渗出
慎密=紧密
蜃楼海市=空中楼阁
升降=起落
生病=抱病
生不逢辰=命途多舛
生成=天生
生果=水果
生活=生存
生活费=米饭钱
生机=生气
生机勃勃=生气勃勃
生计=生存
生怕=恐怕
生平=平生
生气=气愤
生气=生机
生擒=活捉
生疏=陌生
生死=存亡
生死关头=紧要关头
生死之交=刎颈交
生效=见效
生涯=生活
生意=买卖
生育=生养
声东击西=出奇制胜
声名=申明
声势=阵容
声息=声气
声誉=荣誉
声张=张扬
牲口=畜生
牲畜=牲口
胜败=胜负
胜负=胜败
胜过=赛过
省城=省垣
圣人=贤人
圣旨=诏书
盛大=隆重
盛气凌人=不可一世
盛情=盛意
盛装=艳服
尸骨=尸骸
尸骸=尸骨
尸体=遗体
失策=失察
失而复得=合浦珠还
失魂落魄=丢魂失魄
失利=败北
失窃=失贼
失望=扫兴
失业=赋闲
失约=失信
失之交臂=当面错过
失踪=失落
失足=出错
诗人=墨客
施舍=救济
施展=发挥
十恶不赦=罪大恶极
十分=非常
十拿九稳=安若泰山
十全十美=完美无缺
时辰=时候
时代=期间
时光=韶光
时过境迁=明日黄花
时候=时间
时机=机遇
时局=时势
时刻=时候
时时刻刻=每时每刻
时事=时势
时势=局势
时势所迫=格于环境
识别=辨认
识破=看破
识趣=见机
识相=知趣
实话=真话
实际=现实
实力=气力
实情=真相
实施=实行
实时=及时
实习=练习
实行=实验
实验=实行
实在=着实
食物=食品
食斋=吃素
矢志不移=天长地久
使命=任务
使用=利用
始末=委曲
世故=油滑
世间=凡间
世界=天下
世人=众人
世世代代=生生世世
世态炎凉=人情冷暖
市集=墟市
市价=时价
市井=街市商人
市井之徒=屠狗之辈
市侩=奸商
示范=树模
示威=请愿
示意=表示
事变=变乱
事故=变乱
事后=过后
事迹=古迹
事件=变乱
事情=事变
事实=究竟
事势=局势
事态=局势
事务=事件
事业=奇迹
事宜=事件
侍从=随从
侍奉=奉养
势均力敌=半斤八两
势力=权势
视察=观察
视若无睹=置若罔闻
视死如归=成仁取义
试探=摸索
饰物=金饰
饰演=扮演
是非=黑白
是非黑白=青红o白
是非曲直=青红o白
适当=得当
适得其反=拔苗助长
适合=得当
适可而止=恰到好处
适宜=相宜
适应=顺应
适用=实用
释放=开释
誓不两立=不共戴天
收成=收获
收获=劳绩
收集=网络
收容=收留
收拾=摒挡
收手=罢手
收缩=紧缩
收条=收据
手段=本领
手法=伎俩
手下=部下
手艺=技术
手印=指模
守法=遵法
守候=等待
守护=保卫
守卫=保卫
守信=取信
首次=初次
首都=都城
首屈一指=压倒一切
首饰=金饰
首先=起首
首相=宰衡
首要=主要
受宠若惊=被宠若惊
受惠=沾恩
受惊=吃惊
受命=奉命
受骗=上当
授课=讲课
瘦骨如柴=品格清高
书本=书籍
书画=字画
书籍=册本
书写=誊写
抒情=抒怀
疏导=劝导
舒畅=愉快
舒服=惬意
舒服=惬意
舒服=舒适
舒怀=开怀
舒适=舒服
舒展=伸展
输送=运送
输赢=胜负
熟练=纯熟
熟视无睹=置若罔闻
熟悉=认识
束手就擒=计无所出
束手无策=一筹莫展
树大招风=名高引谤
竖立=直立
数不胜数=不可胜数
数量=数目
数目=数量
刷新=革新
衰老=朽迈
衰退=阑珊
衰亡=灭亡
摔倒=跌倒
甩掉=抛弃
双方=两边
爽脆=爽利
爽快=爽直
爽朗=开朗
爽直=坦直
水平=程度
水乳交融=如胶似漆
水土不服=不服水土
水灾=水患
睡房=寝室
睡眠=就寝
睡衣=寝衣
顺便=趁便
顺利=顺遂
顺路=顺道
顺其自然=天真烂漫
顺手=随手
顺水推舟=因利乘便
顺序=次序
瞬间=刹时
说话=语言
说谎=撒谎
说明=阐明
说起=提及
说情=讨情
说笑=谈笑
司空见惯=屡见不鲜
私家=私人
私交=私情
私人=私家
私自=擅自
思考=思索
思路=思绪
思念=缅怀
思索=思考
思维=头脑
思想=头脑
嘶哑=沙哑
撕裂=扯破
死板=枯燥
死不足惜=死有余辜
死灰复然=东山再起
死路=绝路
死气=暮气
死生之交=啮臂之交
死亡=殒命
死心=断念
死刑=极刑
死有余辜=罪不容诛
四处=到处
四海为家=到处为家
四季=四序
四面=四周
四面楚歌=八方受敌
四周=附近
伺候=奉养
似乎=好像
饲养=豢养
松弛=松懈
松散=疏松
松手=放手
松懈=松弛
怂恿=煽动
耸立=矗立
送命=送死
送上=奉上
送死=送命
颂扬=歌颂
搜查=查抄
搜刮=搜索
搜索=搜刮
搜寻=征采
苏醒=清醒
俗气=庸俗
俗语=鄙谚
诉苦=抱怨
肃静=庄严
素来=向来
素昧生平=素不相识
速度=速率
宿怨=旧恨
虽然=固然
随笔=漫笔
随便=任意
随波逐流=同流合污
随处=到处
随从=侍从
随机应变=因地制宜
随声附和=吠影吠声
随手=顺手
随随便便=马马虎虎
随同=伴随
随心所欲=为所欲为
岁数=年龄
岁月=光阴
损害=侵害
损耗=消耗
损坏=破坏
损人利己=假公济私
损失=丧失
唆使=挑拨
缩短=收缩
所向披靡=势如破竹
所向无敌=势如破竹
所以=以是
所有=全部
所在=地点
琐碎=噜苏
抬高=举高
抬举=提拔
抬头=仰面
太监=宦官
太平=平静
贪婪=贪心
贪恋=迷恋
贪图=企图
贪心=贪婪
谈话=发言
谈论=评论
谈判=会商
谈吐=言论
谈笑=言笑
谈心=交心
坦白=坦率
坦荡=开阔
坦率=坦白
坦直=直率
袒护=掩盖
叹气=太息
叹惜=叹惋
探访=拜望
探讨=探究
探望=看望
探问=打听
唐突=冒昧
堂堂正正=大公至正
搪塞=敷衍
滔滔=滚滚
滔滔不绝=口若悬河
韬光养晦=闭门不出
逃避=躲避
逃难=避祸
逃脱=逃走
逃亡=避难
逃走=逃脱
陶冶=熏陶
陶醉=沉醉
淘气=调皮
淘汰=镌汰
讨伐=诛讨
特别=特殊
特长=专长
特出=彪炳
特地=专程
特技=绝技
特殊=特别
特效=殊效
特征=特性
提拔=提升
提防=防范
提纲=提要
提高=进步
提升=提拔
提醒=提示
提议=发起
题目=标题
体裁=文体
体会=领会
体谅=体贴
体面=面子
体无完肤=遍体鳞伤
体现=表现
替代=替换
替换=更换
替身=替人
天边=天涯
天长地久=海誓山盟
天分=天禀
天各一方=天南地北
天黑=入夜
天际=天涯
天气=气候
天然=自然
天堂=天国
天天=每天
天涯=天际
天真=灵活
天资=资质
田地=地步
田野=旷野
田园=故乡
恬静=舒适
甜美=甜蜜
甜头=长处
填补=弥补
填充=添补
挑拨离间=推涛作浪
挑衅=寻衅
挑战=挑衅
眺望=远望
跳舞=舞蹈
贴心=知心
听从=服从
听见=闻声
听命=服从
听天由命=听其自然
停工=歇工
停留=停顿
停业=休业
停战=息兵
停止=制止
停滞不前=故步自封
停住=愣住
挺拔=挺秀
挺立=屹立
挺身而出=自告奋勇
通报=转达
通风=透风
通告=告示
通力合作=共同努力
通俗=普通
通宵=彻夜
通信=通讯
通知=关照
同伴=搭档
同病相怜=惺惺相惜
同仇敌忾=戮力同心
同窗=同学
同党=翅膀
同等=划一
同伙=朋友
同僚=同寅
同流合污=随波逐流
同命鸳鸯=患难夫妻
同情=怜悯
同日而语=等量齐观
同乡=同亲
同心合力=同心并力
同行=偕行
同学=同砚
同志=同道
同舟共济=守望相助
统统=齐备
统一=同一
痛改前非=放下屠刀
痛恨=悔恨
痛苦=痛楚
痛快=愉快
偷盗=偷窃
偷天换日=批红判白
偷偷摸摸=鬼鬼祟祟
投机=谋利
投降=降服佩服
投契=投机
投鼠忌器=有所顾忌
投桃报李=礼尚往来
突然=忽然
图谋不轨=犯上作乱
土地=地皮
土壤=泥土
吐露=流露
团结=连合
团聚=团圆
推崇=推许
推翻=颠覆
推荐=保举
推举=推选
推销=倾销
推心置腹=真心实意
颓废=悲观
退兵=退军
拖拉=拖沓
拖延=耽搁
脱节=摆脱
脱离=离开
脱胎换骨=洗手不干
唾骂=詈骂
挖掘=发掘
挖苦=讥讽
外观=表面
外患=外祸
外交=交际
外面=表面
外套=外衣
外行=生手
外形=形状
外衣=外套
外援=外助
完工=竣工
完好=齐备
完满=美满
完美=完善
完善=美满
完整=完备
玩笑=打趣
顽皮=淘气
顽强=坚强
挽救=拯救
晚年=暮年
惋惜=痛惜
万能=全能
万万=千万
万无一失=十拿九稳
亡命=流亡
往返=来回
往后=今后
往日=昔日
往往=每每
枉然=徒然
妄想=贪图
妄自尊大=井蛙语海
妄作胡为=横行霸道
忘掉=忘记
忘恩负义=不知恩义
旺盛=茂盛
望尘莫及=瞠乎其后
望穿秋水=望眼将穿
望梅止渴=割肉医疮
危机=危急
危险=伤害
危言耸听=骇人听闻
微薄=菲薄
微妙=玄妙
微弱=薄弱
违背=违反
违反=违背
维妙维肖=栩栩如生
伟大=巨大
委屈=委曲
委婉=婉转
未来=将来
温和=暖和
温暖=暖和
温顺=温和
文静=娴静
文雅=高雅
文质彬彬=温文尔雅
文字=笔墨
闻风而动=闻风而逃
闻名=著名
闻名=著名
吻合=符合
稳当=妥当
稳定=稳固
稳健=妥当
稳如泰山=固若金汤
稳重=慎重
问题=题目
问心无愧=心安理得
我见犹怜=楚楚可怜
卧室=寝室
乌黑=黝黑
污秽=腌H
污浊=浑浊
诬蔑=毁谤
无边无际=无边无涯
无独有偶=不足为奇
无端=无故
无法无天=横行霸道
无故=无端
无关紧要=可有可无
无价之宝=价值千金
无可非议=未可厚非
无所畏惧=见义勇为
无所作为=碌碌无为
无限=无穷
无邪=天真
无懈可击=自作掩饰
无意=偶然
午时=中午
午睡=昼寝
午夜=半夜
妩媚=娇媚
忤逆=违逆
武断=果断
侮辱=欺侮
误差=偏差
晤面=见面
夕阳=斜阳
西服=洋装
吸取=汲取
吸收=吸取
希罕=希奇
希奇=奇怪
希望=盼望
昔时=当年
奚落=挖苦
息灭=扑灭
息事宁人=相安无事
息息相关=痛痒相关
牺牲=捐躯
稀奇=特别
稀少=稀疏
稀疏=希罕
稀有=有数
熙熙攘攘=门庭若市
嘻皮笑脸=油腔滑调
习惯=风俗
习以为常=屡见不鲜
袭击=打击
洗耳恭听=倾耳细听
洗心革面=改过自新
洗澡=沐浴
喜爱=喜好
喜出望外=大喜过望
喜好=喜欢
喜欢=喜好
喜剧=笑剧
喜气洋洋=春风得意
喜讯=喜信
喜洋洋=乐陶陶
喜悦=高兴
系统=体系
细密=精密
细腻=精致
细软=金饰
细微=渺小
细小=微小
细心=仔细
细致=过细
狭隘=局促
狭小=狭窄
狭窄=局促
瑕玷=缺点
下班=放工
下场=了局
下等=劣等
下贱=下流
下降=降落
下流=下游
下落=着落
下世=来世
下手=动手
下午=下战书
下学=放学
下游=卑鄙
下昼=下午
下属=部属
吓唬=恐吓
夏季=夏日
夏日=夏季
夏天=炎天
仙境=瑶池
仙人=神仙
先锋=前锋
先进=先辈
先生=老师
先天=天赋
掀开=翻开
鲜明=光显
鲜艳=美丽
闲逸=散逸
贤达=贤能
贤良=贤能
贤明=英明
贤能=贤达
娴静=文静
嫌疑=怀疑
显露=表现
显示=表现
显著=明显
险恶=邪恶
险峻=险要
险诈=刁滑
现代=当代
现实=实际
现象=征象
现在=如今
现状=近况
限制=限定
羡慕=倾慕
乡村=墟落
乡间=乡下
乡下=乡间
乡镇=州里
相称=相当
相当=相称
相等=相称
相逢=邂逅
相符=符合
相干=干系
相关=相干
相机行事=量体裁衣
相见恨晚=相知恨晚
相敬如宾=举案齐眉
相同=雷同
相信=信赖
相宜=适宜
香喷喷=香馥馥
详尽=细致
详实=详确
详细=具体
响应=相应
想方设法=费尽心机
想念=缅怀
向导=领导
削减=减少
削弱=减弱
消费=消耗
消耗=凵
消极=悲观
消灭=清除
消融=溶解
消声匿迹=偃旗息鼓
消失=消散
消逝=消失
消瘦=瘦弱
消亡=灭亡
逍遥=清闲
逍遥法外=逃出法网
萧洒=飘逸
萧条=冷落
销毁=烧毁
销声匿迹=鸣金收兵
销售=贩卖
潇洒=洒脱
小节=末节
小看=鄙视
小气=吝啬
小心=警惕
小心谨慎=胆小如鼠
小心翼翼=战战兢兢
孝敬=孝顺
孝顺=孝敬
效果=结果
效率=服从
校勘=订正
笑里藏刀=口蜜腹剑
笑脸=笑容
笑容=笑脸
笑容可掬=眉开眼笑
笑嘻嘻=笑哈哈
歇业=停业
协调=和谐
协助=帮忙
邪恶=险恶
邪路=歧途
邪念=杂念
斜阳=夕阳
泄漏=走漏
泄露=泄漏
泄气=灰心
亵渎=轻渎
谢绝=推辞
懈怠=怠惰
心安理得=问心无愧
心不在焉=漫不经心
心烦意乱=心乱如麻
心服=心折
心甘情愿=毫不勉强
心花怒放=兴高采烈
心怀叵测=包藏祸心
心慌意乱=方寸已乱
心灰意冷=意气消沉
心惊胆战=闻风丧胆
心惊肉跳=提心吊胆
心旷神怡=赏心悦目
心里=内心
心理=生理
心领神会=心心相印
心乱如麻=心烦意乱
心平气和=平心静气
心如刀割=痛澈心脾
心神不定=心猿意马
心神恍惚=心猿意马
心神专注=聚精会神
心酸=心伤
心算=默算
心心相印=息息相通
心直口快=直肚直肠
心中有数=胸有定见
辛苦=辛劳
辛勤=辛劳
辛酸=酸楚
新房=新居
新奇=新颖
新闻=消息
新鲜=奇怪
新颖=新奇
信奉=信仰
信服=佩服
信口雌黄=言三语四
信口开河=天花乱坠
信赖=信任
信念=信心
信任=信托
信仰=信奉
信用=名誉
兴奋=高兴
兴高采烈=欢欣鼓舞
兴隆=茂盛
兴起=鼓起
兴趣=爱好
兴盛=郁勃
兴师=发兵
兴旺=旺盛
兴致勃勃=兴高采烈
星散=分离
行动=举措
行贿=贿赂
行使=利用
行为=举动
形式=情势
形影不离=形影相随
形状=外形
醒觉=觉醒
醒目=夺目
醒悟=觉醒
幸运=荣幸
性质=性子
凶暴=凶恶
凶残=横暴
凶恶=凶险
凶狠=暴虐
凶猛=猛烈
凶险=凶恶
凶兆=恶兆
胸有成竹=胸中有数
胸中有数=匠意于心
雄伟=宏伟
雄心勃勃=雄心壮志
雄心万丈=壮志凌云
雄心壮志=雄心勃勃
雄壮=富丽
休息=苏息
休业=停业
修好=修睦
修建=构筑
修理=补缀
羞耻=羞辱
羞辱=羞耻
秀丽=奇丽
秀气=清秀
袖手旁观=作壁上观
虚构=假造
虚耗=浪费
虚假=虚伪
虚名=浮名
虚拟=假造
虚弱=衰弱
虚伪=卖弄
虚心=客气
虚有其表=外强中干
虚张声势=矫揉造作
需要=必要
徐徐=渐渐
许多=很多
许可=允许
许诺=答应
栩栩如生=宛在目前
蓄积=积蓄
宣布=公布
喧哗=喧嚣
喧嚣=哗闹
悬念=牵挂
选举=推举
炫耀=夸耀
绚烂=辉煌
绚丽=壮丽
学富五车=才高八斗
学生=门生
雪白=洁白
雪耻=雪恨
雪上加霜=落井下石
雪中送炭=济困解危
血口喷人=含血喷人
寻常=平常
寻找=探求
驯服=顺从
询问=扣问
循序渐进=循规蹈矩
循循善诱=谆谆教导
训斥=谴责
训练=练习
迅速=敏捷
殉国=就义
压迫=克制
压抑=克制
压制=压抑
鸦雀无声=阒寂无声
哑口无言=默不作声
揠苗助长=拔苗助长
淹没=沉没
湮灭=泯没
延长=延伸
延迟=耽误
延续=连续
严惩=重办
严冬=隆冬
严格=严酷
严寒=寒冷
严峻=严肃
严酷=严格
严厉=严肃
严密=精密
严明=严正
严肃=严厉
严阵以待=盛食厉兵
严重=严峻
言不由衷=心口不一
言而无信=出尔反尔
言简意赅=三言两语
言听计从=百依百顺
沿袭=相沿
沿用=相沿
炎热=酷热
奄奄一息=岌岌可危
偃旗息鼓=鸣金收兵
掩蔽=遮蔽
掩盖=掩饰
掩饰=粉饰
眼前=面前
演习=练习
厌恶=讨厌
厌烦=讨厌
厌弃=鄙弃
艳丽=美丽
阳奉阴违=两面三刀
阳间=阳世
洋洋得意=意气扬扬
仰慕=敬慕
仰视=瞻仰
仰望=瞻仰
夭折=短命
邀请=约请
谣言=谎言
摇摆=摇晃
摇动=动摇
摇晃=摇摆
摇摇欲坠=风雨飘摇
遥远=迢遥
咬文嚼字=句斟字嚼
咬牙切齿=痛心疾首
药到病除=妙手回春
要害=关键
耀眼=刺眼
也许=大概
野蛮=蛮横
野外=田野
一败涂地=屁滚尿流
一般=一样平常
一本正经=不苟言笑
一尘不染=纤尘不染
一成不变=刻舟求剑
一筹莫展=束手无策
一蹴而就=一挥而就
一刀两断=薪尽火灭
一定=肯定
一贯=一向
一举两得=一石二鸟
一蹶不振=屁滚尿流
一览无余=一清二楚
一连=连续
一路=一起
一律=同等
一落千丈=江河日下
一毛不拔=爱财如命
一模一样=千篇一律
一目了然=一览无余
一贫如洗=贫无立锥
一气呵成=趁热打铁
一窍不通=一无所知
一切=统统
一日千里=与日俱增
一视同仁=等量齐观
一网打尽=一扫而空
一往无前=勇往直前
一无是处=一无可取
一无所得=一无所获
一无所有=空空如也
一向=一直
一笑置之=付之一笑
一心=同心专心
一心一意=全心全意
一言不发=一声不响
一言九鼎=出言如山
一言为定=说一是一
一一=逐一
一意孤行=独断专行
一应俱全=包罗万象
一语破的=刀刀见血
一再=频频
一针见血=刀刀见血
一知半解=一孔之见
一直=不停
一致=同等
医生=大夫
依旧=仍旧
依靠=依赖
依赖=依靠
依恋=留恋
遗忘=忘记
疑惑=迷惑
疑心=困惑
以前=从前
义不容辞=当仁不让
义无反顾=当仁不让
义务=任务
议和=媾和
异常=非常
异乡=他乡
异议=贰言
抑郁=烦闷
抑制=克制
易如反掌=轻而易举
益友=良朋
意料=料想
意气风发=斗志昂扬
意外=不测
因地制宜=随机应变
因时制宜=随机应变
因为=由于
阴暗=昏暗
阴沉=阴森
阴晦=阴暗
阴历=农历
阴谋=诡计
阴谋诡计=鬼域伎俩
阴险=凶险
殷勤=周到
引经据典=旁征博引
引言=弁言
隐蔽=潜伏
隐藏=隐蔽
隐讳=忌讳
隐瞒=遮盖
隐秘=秘密
隐忍=哑忍
隐约=隐隐
应承=答允
应付自如=应付裕如
应有尽有=包罗万象
英明=贤明
英雄=好汉
迎接=欢迎
迎面=劈面
迎头赶上=奋起直追
盈利=红利
营私舞弊=假公济私
营业=业务
拥护=附和
庸人自扰=杞人忧天
庸俗=卑鄙
臃肿=痴肥
永久=永世
永远=永久
勇敢=大胆
勇往直前=不屈不挠
用功=勤奋
用心=专心
优待=厚待
优点=长处
优点=长处
优良=精良
优美=精美
优美=美丽
优柔=柔嫩
优柔寡断=心神不定
优势=上风
优秀=良好
优异=优秀
优越=良好
忧愁=哀愁
忧虑=担心
忧闷=忧愁
忧伤=难过
忧郁=担心
幽暗=昏暗
幽静=寂静
幽静=清幽
幽香=暗香
悠久=久长
悠然自得=怡然自得
悠闲=清闲
犹如=如同
犹豫=夷由
犹豫不决=心神不定
油滑=调皮
油腔滑调=嘻皮笑脸
游手好闲=吊儿郎当
游玩=嬉戏
友爱=友好
友好=友爱
友情=友谊
友善=和睦
友谊=交情
友谊=情谊
有备无患=防患未然
有的放矢=对症下药
有口皆碑=口碑载道
有名=著名
有名=著名
有趣=风趣
有声有色=绘声绘色
有时=偶然
有始有终=善始善终
有条不紊=井井有条
有头有尾=善始善终
有效=有用
有心=故意
有意=故意
有用=有效
幼稚=稚子
诱惑=勾引
迂腐=陈腐
愉快=舒畅
愉快=痛快
愚蠢=愚笨
愚钝=痴顽
愚昧=屈曲
语无伦次=颠三倒四
语重心长=苦口婆心
郁闷=忧郁
预报=预告
预备=准备
预测=猜测
预防=防备
预告=预报
预赛=初赛
遇到=碰到
遇难=罹难
渊博=广博
元凶=首恶
原本=本来
原谅=包涵
原料=质料
原形=本相
原形毕露=暴露无遗
原因=缘故原由
原由=起因
圆滑=油滑
援助=救济
远程=长途
远大=宏大
远古=太古
远离=阔别
怨恨=痛恨
怨天尤人=怨天恨地
愿意=乐意
约束=束缚
月底=月尾
月亮=玉轮
悦耳=动听
允许=答应
允许=容许
运动=活动
蕴蓄=积聚
杂乱=紊乱
杂乱无章=乱七八糟
灾害=灾难
灾祸=磨难
灾难=劫难
灾难=灾害
栽培=种植
再会=再见
再接再厉=不屈不挠
在世=活着
暂且=临时
暂时=临时
暂停=停息
赞成=同意
赞美=称赞
赞颂=歌颂
赞叹=惊叹
赞同=附和
赞许=赞同
赞扬=歌颂
葬送=断送
糟践=糟蹋
糟蹋=摧残
早晨=清晨
早年=从前
造就=作育
造孽=不法
责备=叱责
责罚=惩罚
责怪=求全谴责
责骂=求全谴责
增加=增长
增进=增长
增强=加强
增添=增加
增援=支援
憎恶=讨厌
憎恨=痛恨
赠送=赠予
赠予=赠送
赠予=赠送
扎实=踏实
榨取=压迫
摘要=择要
窄小=局促
债主=借主
沾沾自喜=志得意满
粘稠=浓厚
瞻望=展望
瞻仰=仰望
斩草除根=鸡犬不留
斩钉截铁=刀切斧砍
展开=睁开
展望=预测
展现=显现
崭露头角=崭露锋芒
崭新=极新
占领=霸占
占有=占据
战败=败北
战胜=克服
战士=兵士
战无不胜=百战百胜
战役=战争
战战兢兢=小心翼翼
战争=战役
战争=战役
张开=伸开
张扬=宣扬
掌握=把握
障碍=停滞
招聘=雇用
召集=调集
照旧=还是
照样=还是
遮蔽=掩藏
遮盖=遮掩
遮掩=掩蔽
折扣=扣头
这样=如许
贞洁=纯洁
侦察=侦探
侦察=侦探
侦探=侦察
珍爱=保护
珍藏=收藏
珍贵=贵重
珍惜=爱惜
真诚=朴拙
真话=实话
真切=逼真
真相=原形
真心=至心
真挚=诚挚
振奋=奋发
镇定=冷静
镇定=镇静
镇静=平静
镇静=镇定
镇压=弹压
震动=震惊
震动=震惊
震惊=震动
争吵=辩论
争持=辩论
争夺=争取
争取=夺取
争先=抢先
争执=辩论
挣脱=摆脱
蒸蒸日上=如日方升
拯救=救济
拯救=挽救
整顿=整理
整洁=整齐
整齐=整洁
整体=团体
正大光明=光明磊落
正当=合法
正好=恰好
正经=端庄
正路=正途
正派=正直
正确=精确
正确=准确
正人君子=正派人物
正途=正路
正午=中午
正义=公理
正直=端正
正直无私=守正不阿
证明=证实
证实=证明
郑重=谨慎
政府=当局
支撑=支持
支出=付出
支付=付出
支离破碎=分崩离析
支援=增援
支援=增援
知名=着名
知足=满足
执迷不悟=至死不渝
执行=实行
直截了当=刀切斧砍
直立=竖立
直言不讳=开门见山
指斥=批评
指导=引导
指点=辅导
指控=控告
指鹿为马=颠倒黑白
指桑骂槐=指鸡骂犬
指使=教唆
指责=责怪
趾高气扬=自鸣得意
至宝=珍宝
至交=至好
至亲=嫡亲
至死不悟=顽固不化
志同道合=同舟共济
制订=制定
制定=订定
制服=礼服
制品=成品
制止=克制
治理=管理
质朴=淳厚
质问=诘责
挚友=好友
智慧=聪明
智慧=伶俐
置若罔闻=视而不见
置之度外=置之不理
中断=停止
中间=中心
中伤=诽谤
中心=中央
中心=中央
中兴=复兴
中央=中心
中止=中断
忠告=警告
忠厚=忠实
忠实=老实
忠心耿耿=赤胆忠心
忠言=忠告
终点=尽头
终结=闭幕
终止=停止
种植=莳植
众多=浩繁
众口纷纭=众说纷纭
众口一词=异口同声
众目睽睽=大庭广众
众说纷纭=众口纷纭
众志成城=众擎易举
重大=庞大
重逢=相逢
重建=重修
重视=器重
重要=紧张
重振旗鼓=大张旗鼓
周到=殷勤
周密=周到
周全=全面
周围=四周
周详=精密
周游=环游
咒骂=唾骂
骤然=蓦地
逐步=渐渐
逐渐=渐渐
主办=主理
主动=自动
主犯=正犯
主要=重要
属下=部属
住手=停止
住宿=留宿
助威=助势
助纣为虐=助桀为虐
注视=凝视
注释=解释
注意=留意
注重=注意
注重=注意
贮备=储备
祝贺=庆贺
著名=闻名
著名=闻名
抓住=捉住
专程=特地
专心=用心
专心=用心
专心致志=全心全意
专一=埋头
专制=独裁
转变=变化
转弯抹角=迂回曲折
转折=迁移转变
赚钱=赢利
妆扮=打扮
妆扮=打扮
庄严=庄重
庄重=庄严
壮大=强大
壮健=矫健
状况=状态
追求=寻求
追随=跟随
准备=预备
准确=正确
准时=定时
准许=答应
卓越=杰出
拙笨=笨拙
拙见=鄙见
捉襟见肘=左支右绌
着急=发急
着手=动手
着重=偏重
仔细=细致
资本=资源
滋长=滋生
滋润=润泽
滋生=繁殖
子女=后代
自暴自弃=自卑过甚
自惭形秽=自感汗颜
自出机杼=别出心裁
自大=自负
自得=得意
自动=主动
自发=自觉
自负=自尊
自甘堕落=苟且偷安
自高自大=目空一切
自告奋勇=挺身而出
自豪=自大
自己=本身
自觉=自发
自夸=自诩
自力=独立
自力更生=白手起家
自立=自主
自满=得意
自命不凡=孤芳自赏
自强不息=发奋图强
自然=天然
自如=自若
自杀=自尽
自食其力=白手起家
自私自利=利欲熏心
自投罗网=自坠陷阱
自信=自大
自圆其说=自作掩饰
自愿=志愿
自在=安闲
自尊=自负
自作自受=作法自毙
总共=统共
总揽=统辖
纵容=放纵
走私=私运
走投无路=断港绝潢
走运=交运
奏效=见效
足够=充足
诅咒=咒骂
阻碍=拦阻
阻挡=拦截
阻隔=隔绝
阻拦=拦阻
阻挠=拦阻
阻塞=壅闭
阻止=制止
阻滞=停滞
组成=构成
组织=构造
祖国=故国
祖先=先人
钻研=研讨
最后=末了
最近=近来
最先=开始
最终=终极
罪大恶极=罪不容诛
罪恶=罪过
罪过=罪行
罪行=恶行
罪有应得=咎由自取
醉生梦死=灯红酒绿
尊崇=敬服
尊贵=高贵
尊敬=尊重
尊重=恭敬
遵从=服从
遵命=服从
遵守=服从
遵循=遵照
遵照=依照
左右逢源=八面玲珑
作对=尴尬刁难
作恶=作歹
作废=取消
作奸犯科=横行霸道
作乱=反叛
作威作福=飞扬跋扈
坐牢=下狱
坐失良机=过后行兵
坐享其成=不劳而获
做事=办事
做作=造作